a	a |
aah	a a h |
abakisaki	a b a k i s a k i |
abakisela	a b a k i s e l a |
abakisi	a b a k i s i |
abala	a b a l a |
abalana	a b a l a n a |
abaloli	a b a l o l i |
abaluki	a b a l u k i |
abalusa	a b a l u s a |
abalusi	a b a l u s i |
abambami	a b a m b a m i |
abanda	a b a n d a |
abandaki	a b a n d a k i |
abandela	a b a n d e l a |
abandeli	a b a n d e l i |
abandi	a b a n d i |
abangi	a b a n g i |
abayer	a b a y e r |
abbattoir	a b b a t t o i r |
abeba	a b e b a |
abelaka	a b e l a k a |
abeleli	a b e l e l i |
abendaka	a b e n d a k a |
abendani	a b e n d a n i |
abendi	a b e n d i |
abenga	a b e n g a |
abengaki	a b e n g a k i |
abengani	a b e n g a n i |
abengi	a b e n g i |
abengisi	a b e n g i s i |
abeta	a b e t a |
abetami	a b e t a m i |
abetami	a b e t a m i |
abetelaki	a b e t e l a k i |
abeteli	a b e t e l i |
abeti	a b e t i |
abiance	a b i a n c e |
abika	a b i k a |
abiki	a b i k i |
abima	a b i m a |
abimaki	a b i m a k i |
abimi	a b i m i |
abimisaki	a b i m i s a k i |
abimisi	a b i m i s i |
aboma	a b o m a |
abomba	a b o m b a |
abombaka	a b o m b a k a |
abomi	a b o m i |
abomisa	a b o m i s a |
abondela	a b o n d e l a |
abongi	a b o n g i |
abongisa	a b o n g i s a |
abongisaki	a b o n g i s a k i |
abongisele	a b o n g i s e l e |
abosanaka	a b o s a n a k a |
abosani	a b o s a n i |
abota	a b o t a |
abotama	a b o t a m a |
abotamaki	a b o t a m a k i |
abotami	a b o t a m i |
aboti	a b o t i |
abotisa	a b o t i s a |
abotoli	a b o t o l i |
aboudaki	a b o u d a k i |
aboule	a b o u l e |
abouler	a b o u l e r |
aboyaki	a b o y a k i |
aboyi	a b o y i |
abukani	a b u k a n i |
abunda	a b u n d a |
abundanaki	a b u n d a n a k i |
abwakeli	a b w a k e l i |
abwaki	a b w a k i |
acauser	a c a u s e r |
achange	a c h a n g e |
acomprendre	a c o m p r e n d r e |
aconclure	a c o n c l u r e |
acorriger	a c o r r i g e r |
adefaki	a d e f a k i |
aeoport	a e o p o r t |
aeoroport	a e o r o p o r t |
aeroport	a e r o p o r t |
afanda	a f a n d a |
afandaka	a f a n d a k a |
afandaki	a f a n d a k i |
afandi	a f a n d i |
afandisaki	a f a n d i s a k i |
afandisi	a f a n d i s i |
afingaka	a f i n g a k a |
afingaki	a f i n g a k i |
afingama	a f i n g a m a |
afingi	a f i n g i |
africaine	a f r i c a i n e |
africains	a f r i c a i n s |
afrika	a f r i k a |
afrique	a f r i q u e |
afundaki	a f u n d a k i |
afungola	a f u n g o l a |
afungolaki	a f u n g o l a k i |
afungolelaki	a f u n g o l e l a k i |
afungoli	a f u n g o l i |
afuta	a f u t a |
afutama	a f u t a m a |
afutelaka	a f u t e l a k a |
afuti	a f u t i |
aganga	a g a n g a |
agangi	a g a n g i |
ageler	a g e l e r |
agene	a g e n e |
ah	a h |
ahn	a h n |
airzaire	a i r z a i r e |
akamwe	a k a m w e |
akanaka	a k a n a k a |
akanaki	a k a n a k i |
akanduki	a k a n d u k i |
akanga	a k a n g a |
akangaki	a k a n g a k i |
akangamaki	a k a n g a m a k i |
akangi	a k a n g i |
akangisa	a k a n g i s a |
akanisa	a k a n i s a |
akanisaka	a k a n i s a k a |
akanisi	a k a n i s i |
akataki	a k a t a k i |
akatanaki	a k a t a n a k i |
akateli	a k a t e l i |
akati	a k a t i |
akatisaka	a k a t i s a k a |
akatisi	a k a t i s i |
akei	a k e i |
akenda	a k e n d a |
akendaka	a k e n d a k a |
akendaki	a k e n d a k i |
akeyi	a k e y i |
akimaka	a k i m a k a |
akimaki	a k i m a k i |
akimi	a k i m i |
akimisaki	a k i m i s a k i |
akipe	a k i p e |
akita	a k i t a |
akitaki	a k i t a k i |
akiti	a k i t i |
akitisaki	a k i t i s a k i |
akitisi	a k i t i s i |
akobaki	a k o b a k i |
akobala	a k o b a l a |
akobangisa	a k o b a n g i s a |
akobeta	a k o b e t a |
akobi	a k o b i |
akobika	a k o b i k a |
akobima	a k o b i m a |
akobimisa	a k o b i m i s a |
akoboma	a k o b o m a |
akobomba	a k o b o m b a |
akobongisa	a k o b o n g i s a |
akobulungana	a k o b u l u n g a n a |
akofuta	a k o f u t a |
akokaki	a k o k a k i |
akoki	a k o k i |
akokipe	a k o k i p e |
akokisa	a k o k i s a |
akokisaki	a k o k i s a k i |
akokisi	a k o k i s i |
akokoka	a k o k o k a |
akokoma	a k o k o m a |
akokota	a k o k o t a |
akokufa	a k o k u f a |
akokɛnda	a k o k ɛ n d a |
akokɛndɛ	a k o k ɛ n d ɛ |
akola	a k o l a |
akolapa	a k o l a p a |
akole	a k o l e |
akoli	a k o l i |
akolinga	a k o l i n g a |
akoliya	a k o l i y a |
akoloba	a k o l o b a |
akolongolela	a k o l o n g o l e l a |
akoluka	a k o l u k a |
akoma	a k o m a |
akomaka	a k o m a k a |
akomaki	a k o m a k i |
akomi	a k o m i |
akomisa	a k o m i s a |
akomona	a k o m o n a |
akomonela	a k o m o n e l a |
akomɛla	a k o m ɛ l a |
akoningana	a k o n i n g a n a |
akonzi	a k o n z i |
akopambola	a k o p a m b o l a |
akopesa	a k o p e s a |
akosaka	a k o s a k a |
akosaki	a k o s a k i |
akosala	a k o s a l a |
akosalisa	a k o s a l i s a |
akosepela	a k o s e p e l a |
akosepelisa	a k o s e p e l i s a |
akosi	a k o s i |
akosikosi	a k o s i k o s i |
akosomba	a k o s o m b a |
akosuba	a k o s u b a |
akosukola	a k o s u k o l a |
akosunga	a k o s u n g a |
akota	a k o t a |
akotaki	a k o t a k i |
akotanga	a k o t a n g a |
akoti	a k o t i |
akotika	a k o t i k a |
akotisa	a k o t i s a |
akotisaki	a k o t i s a k i |
akotisi	a k o t i s i |
akotubela	a k o t u b e l a |
akowuta	a k o w u t a |
akoya	a k o y a |
akoyeba	a k o y e b a |
akoyebisa	a k o y e b i s a |
akoyoka	a k o y o k a |
akoyɔka	a k o y ɔ k a |
akozanga	a k o z a n g a |
akozela	a k o z e l a |
akozonga	a k o z o n g a |
akozongela	a k o z o n g e l a |
akozwa	a k o z w a |
akufa	a k u f a |
akufaka	a k u f a k a |
akufaki	a k u f a k i |
akufi	a k u f i |
akutanaki	a k u t a n a k i |
akutani	a k u t a n i |
akuti	a k u t i |
akutuna	a k u t u n a |
akweyaki	a k w e y a k i |
akweyi	a k w e y i |
akɛndɛ	a k ɛ n d ɛ |
akɛndɛki	a k ɛ n d ɛ k i |
alakisa	a l a k i s a |
alakisi	a l a k i s i |
alala	a l a l a |
alalaka	a l a l a k a |
alalaki	a l a l a k i |
alaleli	a l a l e l i |
alali	a l a l i |
alaliseli	a l a l i s e l i |
alamba	a l a m b a |
alamuka	a l a m u k a |
alamuki	a l a m u k i |
alamusi	a l a m u s i |
alapa	a l a p a |
alapaka	a l a p a k a |
alapi	a l a p i |
alata	a l a t a |
alataka	a l a t a k a |
alataki	a l a t a k i |
alati	a l a t i |
alcool	a l c o o l |
alei	a l e i |
aleka	a l e k a |
alekaka	a l e k a k a |
alekaki	a l e k a k i |
alekani	a l e k a n i |
aleki	a l e k i |
alekisaki	a l e k i s a k i |
alela	a l e l a |
alelaka	a l e l a k a |
aleli	a l e l i |
alembaki	a l e m b a k i |
alembi	a l e m b i |
alengisi	a l e n g i s i |
aleyi	a l e y i |
ali	a l i |
alia	a l i a |
aliaka	a l i a k a |
aliaki	a l i a k i |
alie	a l i e |
alimwa	a l i m w a |
alinga	a l i n g a |
alingaka	a l i n g a k a |
alingaki	a l i n g a k i |
alingi	a l i n g i |
allemagne	a l l e m a g n e |
allons	a l l o n s |
aloba	a l o b a |
alobaka	a l o b a k a |
alobaki	a l o b a k i |
alobelaki	a l o b e l a k i |
alobeli	a l o b e l i |
alobi	a l o b i |
alobisa	a l o b i s a |
alokota	a l o k o t a |
alona	a l o n a |
alongaka	a l o n g a k a |
alongisi	a l o n g i s i |
alongoli	a l o n g o l i |
alongwaki	a l o n g w a k i |
alongwe	a l o n g w e |
alotaka	a l o t a k a |
alube	a l u b e |
aluki	a l u k i |
alulaka	a l u l a k a |
alulaki	a l u l a k i |
amamoli	a m a m o l i |
amata	a m a t a |
amataki	a m a t a k i |
amati	a m a t i |
amatisi	a m a t i s i |
ambabel	a m b a b e l |
ambassade	a m b a s s a d e |
ambassadeur	a m b a s s a d e u r |
ambiance	a m b i a n c e |
ameka	a m e k a |
amekaka	a m e k a k a |
ameki	a m e k i |
ameli	a m e l i |
amelisi	a m e l i s i |
amema	a m e m a |
amemaki	a m e m a k i |
amemelaki	a m e m e l a k i |
amemeli	a m e m e l i |
amemi	a m e m i |
amerika	a m e r i k a |
amerique	a m e r i q u e |
amesana	a m e s a n a |
ameseni	a m e s e n i |
amibengaka	a m i b e n g a k a |
amibongisi	a m i b o n g i s i |
amikangaka	a m i k a n g a k a |
amikanisaka	a m i k a n i s a k a |
amilobelaki	a m i l o b e l a k i |
amilobeli	a m i l o b e l i |
amilobi	a m i l o b i |
aminyɔlisi	a m i n y ɔ l i s i |
amipesa	a m i p e s a |
amisaleli	a m i s a l e l i |
amitielaki	a m i t i e l a k i |
amitii	a m i t i i |
amitiki	a m i t i k i |
amitungisamaki	a m i t u n g i s a m a k i |
amituni	a m i t u n i |
amiyanoli	a m i y a n o l i |
amiyɔkeli	a m i y ɔ k e l i |
amiyɔki	a m i y ɔ k i |
amona	a m o n a |
amonaka	a m o n a k a |
amonaki	a m o n a k i |
amonela	a m o n e l a |
amoni	a m o n i |
amozongiseli	a m o z o n g i s e l i |
ampɔnaka	a m p ɔ n a k a |
ampɔnaki	a m p ɔ n a k i |
amɛla	a m ɛ l a |
andima	a n d i m a |
andimaki	a n d i m a k i |
andimi	a n d i m i |
angana	a n g a n a |
angola	a n g o l a |
animation	a n i m a t i o n |
aningana	a n i n g a n a |
aningisi	a n i n g i s i |
ans	a n s |
ansosoli	a n s o s o l i |
anthony	a n t h o n y |
antigang	a n t i g a n g |
anto	a n t o |
antoine	a n t o i n e |
antony	a n t o n y |
anu	a n u |
anyati	a n y a t i |
anyɔkwama	a n y ɔ k w a m a |
anyɔkwamaki	a n y ɔ k w a m a k i |
anzelu	a n z e l u |
aom	a o m |
apakati	a p a k a t i |
apambola	a p a m b o l a |
apangusaki	a p a n g u s a k i |
apangusi	a p a n g u s i |
apate	a p a t e |
apekisa	a p e k i s a |
apekisaka	a p e k i s a k a |
apekisi	a p e k i s i |
apemaki	a p e m a k i |
apemi	a p e m i |
apesa	a p e s a |
apesaki	a p e s a k i |
apres	a p r e s |
aprofiter	a p r o f i t e r |
aptitude	a p t i t u d e |
apumbuki	a p u m b u k i |
apupoli	a p u p o l i |
apusana	a p u s a n a |
apusanaki	a p u s a n a k i |
apusani	a p u s a n i |
apusi	a p u s i |
araisonner	a r a i s o n n e r |
aresister	a r e s i s t e r |
arret	a r r e t |
arthur	a r t h u r |
asakana	a s a k a n a |
asakoleli	a s a k o l e l i |
asala	a s a l a |
asalaka	a s a l a k a |
asalaki	a s a l a k i |
asalela	a s a l e l a |
asalelaki	a s a l e l a k i |
asali	a s a l i |
asalisa	a s a l i s a |
asalisaki	a s a l i s a k i |
asalisi	a s a l i s i |
asambisi	a s a m b i s i |
asambwe	a s a m b w e |
asambɛlɛla	a s a m b ɛ l ɛ l a |
asangisi	a s a n g i s i |
asbl	a s b l |
ascenceur	a s c e n c e u r |
asedecider	a s e d e c i d e r |
asekaka	a s e k a k a |
aseki	a s e k i |
asengaki	a s e n g a k i |
asengeli	a s e n g e l i |
asengi	a s e n g i |
asepela	a s e p e l a |
asepelaki	a s e p e l a k i |
asepeli	a s e p e l i |
asi	a s i |
asii	a s i i |
asilaki	a s i l a k i |
asili	a s i l i |
asilikaka	a s i l i k a k a |
asilikaki	a s i l i k a k i |
asiliki	a s i l i k i |
asilisa	a s i l i s a |
asilisaki	a s i l i s a k i |
asilisi	a s i l i s i |
asimba	a s i m b a |
asimbi	a s i m b i |
asimbisi	a s i m b i s i |
asomba	a s o m b a |
asombaka	a s o m b a k a |
asombaki	a s o m b a k i |
asombelaki	a s o m b e l a k i |
asombi	a s o m b i |
asuka	a s u k a |
asukisa	a s u k i s a |
asukisi	a s u k i s i |
asukola	a s u k o l a |
asukolaka	a s u k o l a k a |
asukoli	a s u k o l i |
asundola	a s u n d o l a |
asunga	a s u n g a |
asungaki	a s u n g a k i |
asungi	a s u n g i |
asutukaki	a s u t u k a k i |
asutuki	a s u t u k i |
aswanaki	a s w a n a k i |
ata	a t a |
atala	a t a l a |
atalaki	a t a l a k i |
atali	a t a l i |
atambola	a t a m b o l a |
atambolaka	a t a m b o l a k a |
atambolaki	a t a m b o l a k i |
atambusa	a t a m b u s a |
atambusaki	a t a m b u s a k i |
atanga	a t a n g a |
atangaka	a t a n g a k a |
atangeli	a t a n g e l i |
atangisaki	a t a n g i s a k i |
ateka	a t e k a |
atekaka	a t e k a k a |
atekeli	a t e k e l i |
atekisaka	a t e k i s a k a |
atekisi	a t e k i s i |
atelema	a t e l e m a |
atelemaki	a t e l e m a k i |
atelemi	a t e l e m i |
atelemisaki	a t e l e m i s a k i |
atelemisi	a t e l e m i s i |
atengama	a t e n g a m a |
atia	a t i a |
atiaki	a t i a k i |
atie	a t i e |
atielaki	a t i e l a k i |
atika	a t i k a |
atikaki	a t i k a k i |
atikala	a t i k a l a |
atikalaka	a t i k a l a k a |
atikalaki	a t i k a l a k i |
atikali	a t i k a l i |
atikela	a t i k e l a |
atiki	a t i k i |
atimbelaki	a t i m b e l a k i |
atindi	a t i n d i |
atiya	a t i y a |
atlantik	a t l a n t i k |
atomboki	a t o m b o k i |
atomboli	a t o m b o l i |
atosa	a t o s a |
atshayaka	a t s h a y a k a |
attendant	a t t e n d a n t |
atubela	a t u b e l a |
atubelaki	a t u b e l a k i |
atumoli	a t u m o l i |
atunaki	a t u n a k i |
atuni	a t u n i |
atutaki	a t u t a k i |
atuti	a t u t i |
au	a u |
auditorat	a u d i t o r a t |
auguy	a u g u y |
aujourdhui	a u j o u r d h u i |
avant	a v a n t |
avenir	a v e n i r |
avenue	a v e n u e |
avion	a v i o n |
awa	a w a |
awumela	a w u m e l a |
awumelaki	a w u m e l a k i |
awuta	a w u t a |
awutaki	a w u t a k i |
awuti	a w u t i |
aya	a y a |
ayaka	a y a k a |
ayaki	a y a k i |
ayambaki	a y a m b a k i |
ayambi	a y a m b i |
ayanolaki	a y a n o l a k i |
ayanoli	a y a n o l i |
aye	a y e |
ayebanaki	a y e b a n a k i |
ayebelaka	a y e b e l a k a |
ayebi	a y e b i |
ayebika	a y e b i k a |
ayebiki	a y e b i k i |
ayebisa	a y e b i s a |
ayebisaki	a y e b i s a k i |
ayebisi	a y e b i s i |
ayei	a y e i |
ayemba	a y e m b a |
ayembaka	a y e m b a k a |
ayibaki	a y i b a k i |
ayibi	a y i b i |
ayoka	a y o k a |
ayokaka	a y o k a k a |
ayokaki	a y o k a k i |
ayɔkela	a y ɔ k e l a |
ayɔki	a y ɔ k i |
aza	a z a |
azala	a z a l a |
azalaka	a z a l a k a |
azalaki	a z a l a k i |
azali	a z a l i |
azanga	a z a n g a |
azangaka	a z a n g a k a |
azela	a z e l a |
azelaka	a z e l a k a |
azelaki	a z e l a k i |
azelisaki	a z e l i s a k i |
azoboya	a z o b o y a |
azokana	a z o k a n a |
azoki	a z o k i |
azokoma	a z o k o m a |
azoluka	a z o l u k a |
azonga	a z o n g a |
azongaki	a z o n g a k i |
azongeli	a z o n g e l i |
azongi	a z o n g i |
azongisaki	a z o n g i s a k i |
azongisela	a z o n g i s e l a |
azongiseli	a z o n g i s e l i |
azongisi	a z o n g i s i |
azosala	a z o s a l a |
azosambwisa	a z o s a m b w i s a |
azotala	a z o t a l a |
azoyeba	a z o y e b a |
azoyebisa	a z o y e b i s a |
azoyela	a z o y e l a |
azozela	a z o z e l a |
azozonga	a z o z o n g a |
azozwela	a z o z w e l a |
azwa	a z w a |
azwaka	a z w a k a |
azwaki	a z w a k i |
azwela	a z w e l a |
azwelaki	a z w e l a k i |
azwi	a z w i |
b	b |
ba	b a |
baallure	b a a l l u r e |
baattaque	b a a t t a q u e |
baba	b a b a |
babakisi	b a b a k i s i |
babalabala	b a b a l a b a l a |
babalaka	b a b a l a k a |
babalana	b a b a l a n a |
babalanaka	b a b a l a n a k a |
babale	b a b a l e |
babaluki	b a b a l u k i |
babandi	b a b a n d i |
babangaka	b a b a n g a k a |
babanques	b a b a n q u e s |
babatelinzoto	b a b a t e l i n z o t o |
babayaki	b a b a y a k i |
babayer	b a b a y e r |
babebe	b a b e b e |
babebisaka	b a b e b i s a k a |
babebisaki	b a b e b i s a k i |
babebisela	b a b e b i s e l a |
babeleli	b a b e l e l i |
babelge	b a b e l g e |
babelgicains	b a b e l g i c a i n s |
babendana	b a b e n d a n a |
babendi	b a b e n d i |
babenefice	b a b e n e f i c e |
babenga	b a b e n g a |
babengaka	b a b e n g a k a |
babengaki	b a b e n g a k i |
babengana	b a b e n g a n a |
babenganaki	b a b e n g a n a k i |
babengani	b a b e n g a n i |
babengi	b a b e n g i |
babengisi	b a b e n g i s i |
babenzula	b a b e n z u l a |
babeta	b a b e t a |
babetaka	b a b e t a k a |
babetama	b a b e t a m a |
babeti	b a b e t i |
babimaka	b a b i m a k a |
babimi	b a b i m i |
babimisaki	b a b i m i s a k i |
babimisi	b a b i m i s i |
babindre	b a b i n d r e |
babisi	b a b i s i |
babola	b a b o l a |
baboma	b a b o m a |
babomi	b a b o m i |
babongisa	b a b o n g i s a |
babongisi	b a b o n g i s i |
babonza	b a b o n z a |
babonzelaki	b a b o n z e l a k i |
babosana	b a b o s a n a |
babota	b a b o t a |
babotama	b a b o t a m a |
babotamaka	b a b o t a m a k a |
babotamaki	b a b o t a m a k i |
baboti	b a b o t i |
babotisi	b a b o t i s i |
baboudaki	b a b o u d a k i |
baboudelaka	b a b o u d e l a k a |
baboul	b a b o u l |
baboya	b a b o y a |
baboyaki	b a b o y a k i |
baboyi	b a b o y i |
babrique	b a b r i q u e |
babriquetier	b a b r i q u e t i e r |
babuka	b a b u k a |
babukani	b a b u k a n i |
babuki	b a b u k i |
babuku	b a b u k u |
babundaki	b a b u n d a k i |
babureau	b a b u r e a u |
babwakamaki	b a b w a k a m a k i |
babwaki	b a b w a k i |
bacahier	b a c a h i e r |
bacamarade	b a c a m a r a d e |
bacarte	b a c a r t e |
bacartes	b a c a r t e s |
bacartons	b a c a r t o n s |
bachampagne	b a c h a m p a g n e |
bacharme	b a c h a r m e |
bachinois	b a c h i n o i s |
bacoin	b a c o i n |
bacommissionnaire	b a c o m m i s s i o n n a i r e |
bacommunes	b a c o m m u n e s |
bacomprena	b a c o m p r e n a |
bacomprendre	b a c o m p r e n d r e |
bacongolais	b a c o n g o l a i s |
bacoop	b a c o o p |
bacote	b a c o t e |
bacroyaka	b a c r o y a k a |
badalungwa	b a d a l u n g w a |
badamage	b a d a m a g e |
badefaut	b a d e f a u t |
badefi	b a d e f i |
bademarches	b a d e m a r c h e s |
badepots	b a d e p o t s |
badernier	b a d e r n i e r |
badeviz	b a d e v i z |
badictateur	b a d i c t a t e u r |
badiscours	b a d i s c o u r s |
badoki	b a d o k i |
badolar	b a d o l a r |
badossier	b a d o s s i e r |
badroit	b a d r o i t |
baemission	b a e m i s s i o n |
baetudiant	b a e t u d i a n t |
baexamen	b a e x a m e n |
baexemple	b a e x e m p l e |
baexpliquer	b a e x p l i q u e r |
bafamille	b a f a m i l l e |
bafamilles	b a f a m i l l e s |
bafanda	b a f a n d a |
bafandaka	b a f a n d a k a |
bafandaki	b a f a n d a k i |
bafandi	b a f a n d i |
bafaux	b a f a u x |
bafazeur	b a f a z e u r |
baffle	b a f f l e |
bafinga	b a f i n g a |
bafingi	b a f i n g i |
bafrancais	b a f r a n c a i s |
bafrites	b a f r i t e s |
bafulafula	b a f u l a f u l a |
bafundaki	b a f u n d a k i |
bafundi	b a f u n d i |
bafungola	b a f u n g o l a |
bafungolaki	b a f u n g o l a k i |
bafungolela	b a f u n g o l e l a |
bafungoli	b a f u n g o l i |
bafuta	b a f u t a |
bafutaka	b a f u t a k a |
bafuti	b a f u t i |
bagardecivil	b a g a r d e c i v i l |
bagendarmes	b a g e n d a r m e s |
baghetto	b a g h e t t o |
bagrand	b a g r a n d |
bagrandpretre	b a g r a n d p r e t r e |
baheure	b a h e u r e |
bahibou	b a h i b o u |
baimmeuble	b a i m m e u b l e |
bainteret	b a i n t e r e t |
bainvitation	b a i n v i t a t i o n |
bajeannine	b a j e a n n i n e |
bajeu	b a j e u |
bajour	b a j o u r |
bajuges	b a j u g e s |
bakabaka	b a k a b a k a |
bakabwana	b a k a b w a n a |
bakala	b a k a l a |
bakalingi	b a k a l i n g i |
bakamba	b a k a m b a |
bakambwana	b a k a m b w a n a |
bakambwanaki	b a k a m b w a n a k i |
bakamwaka	b a k a m w a k a |
bakamwe	b a k a m w e |
bakana	b a k a n a |
bakanga	b a k a n g a |
bakangaka	b a k a n g a k a |
bakangaki	b a k a n g a k i |
bakangela	b a k a n g e l a |
bakangi	b a k a n g i |
bakanisa	b a k a n i s a |
bakanisaki	b a k a n i s a k i |
bakara	b a k a r a |
bakata	b a k a t a |
bakati	b a k a t i |
bakatini	b a k a t i n i |
bakatisi	b a k a t i s i |
bakei	b a k e i |
bakelasi	b a k e l a s i |
bakelela	b a k e l e l a |
bakenda	b a k e n d a |
bakendaka	b a k e n d a k a |
bakendeke	b a k e n d e k e |
bakesi	b a k e s i |
baketch	b a k e t c h |
bakeyi	b a k e y i |
bakimaki	b a k i m a k i |
bakimisaki	b a k i m i s a k i |
bakipa	b a k i p a |
bakipe	b a k i p e |
bakisi	b a k i s i |
bakita	b a k i t a |
bakiti	b a k i t i |
bakitisi	b a k i t i s i |
baklando	b a k l a n d o |
bakobaka	b a k o b a k a |
bakobanda	b a k o b a n d a |
bakobandela	b a k o b a n d e l a |
bakobanga	b a k o b a n g a |
bakobenda	b a k o b e n d a |
bakocomprendre	b a k o c o m p r e n d r e |
bakofungola	b a k o f u n g o l a |
bakokaka	b a k o k a k a |
bakokaki	b a k o k a k i |
bakokamwa	b a k o k a m w a |
bakoki	b a k o k i |
bakokɛndɛ	b a k o k ɛ n d ɛ |
bakola	b a k o l a |
bakolaka	b a k o l a k a |
bakolala	b a k o l a l a |
bakoli	b a k o l i |
bakoliya	b a k o l i y a |
bakolo	b a k o l o |
bakoloba	b a k o l o b a |
bakolongola	b a k o l o n g o l a |
bakoluka	b a k o l u k a |
bakolɛmba	b a k o l ɛ m b a |
bakoma	b a k o m a |
bakomaka	b a k o m a k a |
bakomaki	b a k o m a k i |
bakombi	b a k o m b i |
bakomi	b a k o m i |
bakomisa	b a k o m i s a |
bakomisi	b a k o m i s i |
bakomona	b a k o m o n a |
bakomonana	b a k o m o n a n a |
bakomɛla	b a k o m ɛ l a |
bakongo	b a k o n g o |
bakonzi	b a k o n z i |
bakosa	b a k o s a |
bakosaka	b a k o s a k a |
bakosala	b a k o s a l a |
bakosenga	b a k o s e n g a |
bakosomba	b a k o s o m b a |
bakotaki	b a k o t a k i |
bakoti	b a k o t i |
bakotikala	b a k o t i k a l a |
bakotinda	b a k o t i n d a |
bakotisi	b a k o t i s i |
bakotonda	b a k o t o n d a |
bakotungisa	b a k o t u n g i s a |
bakowuta	b a k o w u t a |
bakoya	b a k o y a |
bakoyamba	b a k o y a m b a |
bakoyekola	b a k o y e k o l a |
bakoyiba	b a k o y i b a |
bakozala	b a k o z a l a |
bakozonga	b a k o z o n g a |
bakozwa	b a k o z w a |
bakristu	b a k r i s t u |
bakufa	b a k u f a |
bakufaka	b a k u f a k a |
bakufaki	b a k u f a k i |
bakufelaka	b a k u f e l a k a |
bakufi	b a k u f i |
bakuluna	b a k u l u n a |
bakulutu	b a k u l u t u |
bakumbi	b a k u m b i |
bakundaki	b a k u n d a k i |
bakundi	b a k u n d i |
bakurage	b a k u r a g e |
bakutana	b a k u t a n a |
bakutanaka	b a k u t a n a k a |
bakutanaki	b a k u t a n a k i |
bakuzu	b a k u z u |
bakɔkɔ	b a k ɔ k ɔ |
bakɔkɔka	b a k ɔ k ɔ k a |
bakɔkɔma	b a k ɔ k ɔ m a |
bakɛndɛ	b a k ɛ n d ɛ |
bakɛndɛke	b a k ɛ n d ɛ k e |
bakɛndɛki	b a k ɛ n d ɛ k i |
balabala	b a l a b a l a |
balakani	b a l a k a n i |
balakisi	b a l a k i s i |
balala	b a l a l a |
balalaki	b a l a l a k i |
balali	b a l a l i |
balanda	b a l a n d a |
balandi	b a l a n d i |
balangwa	b a l a n g w a |
balar	b a l a r |
balata	b a l a t a |
balataka	b a l a t a k a |
baleka	b a l e k a |
baleki	b a l e k i |
balekisaki	b a l e k i s a k i |
baleyi	b a l e y i |
balibanais	b a l i b a n a i s |
balingaka	b a l i n g a k a |
balingaki	b a l i n g a k i |
balinganaka	b a l i n g a n a k a |
balinganaki	b a l i n g a n a k i |
balingi	b a l i n g i |
baloba	b a l o b a |
balobaka	b a l o b a k a |
balobaki	b a l o b a k i |
balobi	b a l o b i |
balokotaka	b a l o k o t a k a |
balonga	b a l o n g a |
balongola	b a l o n g o l a |
balongolaki	b a l o n g o l a k i |
balongoli	b a l o n g o l i |
balongwaki	b a l o n g w a k i |
balongwe	b a l o n g w e |
baluba	b a l u b a |
baluka	b a l u k a |
baluki	b a l u k i |
balukisaki	b a l u k i s a k i |
baluozi	b a l u o z i |
balɔka	b a l ɔ k a |
balɛmba	b a l ɛ m b a |
bamacon	b a m a c o n |
bamakambo	b a m a k a m b o |
bamakambu	b a m a k a m b u |
bamakambuango	b a m a k a m b u a n g o |
bamama	b a m a m a |
bamandona	b a m a n d o n a |
bamaputa	b a m a p u t a |
bamarechal	b a m a r e c h a l |
bamasanga	b a m a s a n g a |
bamashini	b a m a s h i n i |
bamataki	b a m a t a k i |
bamati	b a m a t i |
bamayi	b a m a y i |
bambala	b a m b a l a |
bambata	b a m b a t a |
bambendre	b a m b e n d r e |
bambikudi	b a m b i k u d i |
bamboka	b a m b o k a |
bambote	b a m b o t e |
bambula	b a m b u l a |
bambɔgɔ	b a m b ɔ g ɔ |
bameka	b a m e k a |
bameki	b a m e k i |
bamemaki	b a m e m a k i |
bamemela	b a m e m e l a |
bamemeli	b a m e m e l i |
bamemi	b a m e m i |
bamenace	b a m e n a c e |
bamesana	b a m e s a n a |
bametre	b a m e t r e |
bamfumulele	b a m f u m u l e l e |
bamgu	b a m g u |
bamibatela	b a m i b a t e l a |
bamiboma	b a m i b o m a |
bamikili	b a m i k i l i |
bamilingaka	b a m i l i n g a k a |
bamilobelanaki	b a m i l o b e l a n a k i |
bamilobeli	b a m i l o b e l i |
bamimonisaki	b a m i m o n i s a k i |
baminerval	b a m i n e r v a l |
baminganga	b a m i n g a n g a |
bamipesaka	b a m i p e s a k a |
bamiraesa	b a m i r a e s a |
bamisala	b a m i s a l a |
bamista	b a m i s t a |
bamisusu	b a m i s u s u |
bamomi	b a m o m i |
bamona	b a m o n a |
bamonaka	b a m o n a k a |
bamonaki	b a m o n a k i |
bamonana	b a m o n a n a |
bamoni	b a m o n i |
bamoyen	b a m o y e n |
bampasi	b a m p a s i |
bampion	b a m p i o n |
bampɔna	b a m p ɔ n a |
bamvula	b a m v u l a |
bamwangani	b a m w a n g a n i |
bamystiquaka	b a m y s t i q u a k a |
bamɛla	b a m ɛ l a |
bamɛli	b a m ɛ l i |
bana	b a n a |
banabasi	b a n a b a s i |
banande	b a n a n d e |
banani	b a n a n i |
banationaliste	b a n a t i o n a l i s t e |
banbongisaka	b a n b o n g i s a k a |
banda	b a n d a |
bandako	b a n d a k o |
bandal	b a n d a l |
bandeko	b a n d e k o |
bandenge	b a n d e n g e |
bandi	b a n d i |
bandima	b a n d i m a |
bandimi	b a n d i m i |
bandoki	b a n d o k i |
banduliste	b a n d u l i s t e |
bandundu	b a n d u n d u |
bandɔtɔ	b a n d ɔ t ɔ |
bangamba	b a n g a m b a |
bangamelo	b a n g a m e l o |
banganda	b a n g a n d a |
bangando	b a n g a n d o |
banganga	b a n g a n g a |
bangaya	b a n g a y a |
bangi	b a n g i |
bango	b a n g o |
bangonga	b a n g o n g a |
baninga	b a n i n g a |
banini	b a n i n i |
banki	b a n k i |
bankombo	b a n k o m b o |
banoko	b a n o k o |
banque	b a n q u e |
bansango	b a n s a n g o |
banso	b a n s o |
banzala	b a n z a l a |
banzela	b a n z e l a |
banzele	b a n z e l e |
banzembo	b a n z e m b o |
banzete	b a n z e t e |
banzinzi	b a n z i n z i |
banzungu	b a n z u n g u |
baoperation	b a o p e r a t i o n |
baoyɔ	b a o y ɔ |
bapagano	b a p a g a n o |
bapalangani	b a p a l a n g a n i |
bapantalons	b a p a n t a l o n s |
bapanzi	b a p a n z i |
bapapier	b a p a p i e r |
baparisiens	b a p a r i s i e n s |
bapasteurs	b a p a s t e u r s |
bapatron	b a p a t r o n |
bapaya	b a p a y a |
bapekisa	b a p e k i s a |
bapeliseli	b a p e l i s e l i |
bapemaka	b a p e m a k a |
baperdaki	b a p e r d a k i |
bapere	b a p e r e |
bapesa	b a p e s a |
bapesaka	b a p e s a k a |
bapesanaki	b a p e s a n a k i |
bapesani	b a p e s a n i |
bapetits	b a p e t i t s |
bapimela	b a p i m e l a |
bapimeli	b a p i m e l i |
baplacaka	b a p l a c a k a |
baplace	b a p l a c e |
baplan	b a p l a n |
baplastiques	b a p l a s t i q u e s |
bapolice	b a p o l i c e |
bapolicier	b a p o l i c i e r |
bapoliciers	b a p o l i c i e r s |
bapolo	b a p o l o |
bapomba	b a p o m b a |
baponi	b a p o n i |
baposa	b a p o s a |
bapotana	b a p o t a n a |
bapoteau	b a p o t e a u |
bappareil	b a p p a r e i l |
bapretre	b a p r e t r e |
baprojet	b a p r o j e t |
bapure	b a p u r e |
bapusana	b a p u s a n a |
baquatre	b a q u a t r e |
baquin	b a q u i n |
bar	b a r |
baraisons	b a r a i s o n s |
barealite	b a r e a l i t e |
bareflexion	b a r e f l e x i o n |
barefouler	b a r e f o u l e r |
baremarquer	b a r e m a r q u e r |
barenvoyer	b a r e n v o y e r |
barisque	b a r i s q u e |
barman	b a r m a n |
baroman	b a r o m a n |
barumbu	b a r u m b u |
basakana	b a s a k a n a |
basakanaka	b a s a k a n a k a |
basala	b a s a l a |
basalade	b a s a l a d e |
basalaka	b a s a l a k a |
basalaki	b a s a l a k i |
basalela	b a s a l e l a |
basalelaki	b a s a l e l a k i |
basali	b a s a l i |
basambelaka	b a s a m b e l a k a |
basambelaki	b a s a m b e l a k i |
basanganaki	b a s a n g a n a k i |
basangani	b a s a n g a n i |
basango	b a s a n g o |
basangombangunza	b a s a n g o m b a n g u n z a |
basani	b a s a n i |
basanza	b a s a n z a |
basapato	b a s a p a t o |
basapeur	b a s a p e u r |
basapeurs	b a s a p e u r s |
basarah	b a s a r a h |
basashe	b a s a s h e |
basavants	b a s a v a n t s |
baseconde	b a s e c o n d e |
basekaki	b a s e k a k i |
basengaka	b a s e n g a k a |
basengaki	b a s e n g a k i |
basengi	b a s e n g i |
basepela	b a s e p e l a |
basepelaki	b a s e p e l a k i |
basepi	b a s e p i |
bashekula	b a s h e k u l a |
basi	b a s i |
basile	b a s i l e |
basili	b a s i l i |
basilika	b a s i l i k a |
basilisa	b a s i l i s a |
basilisi	b a s i l i s i |
basilissi	b a s i l i s s i |
basmartfone	b a s m a r t f o n e |
basociete	b a s o c i e t e |
basoda	b a s o d a |
basoeur	b a s o e u r |
basololaka	b a s o l o l a k a |
basololaki	b a s o l o l a k i |
basololi	b a s o l o l i |
basomba	b a s o m b a |
basombaka	b a s o m b a k a |
basombaki	b a s o m b a k i |
basombal	b a s o m b a l |
basombi	b a s o m b i |
basonge	b a s o n g e |
basuka	b a s u k a |
basukaki	b a s u k a k i |
basukali	b a s u k a l i |
basukola	b a s u k o l a |
basunga	b a s u n g a |
basusu	b a s u s u |
basutuka	b a s u t u k a |
batala	b a t a l a |
batalaka	b a t a l a k a |
batalaki	b a t a l a k i |
batalani	b a t a l a n i |
batali	b a t a l i |
batalisaki	b a t a l i s a k i |
batambola	b a t a m b o l a |
batambolaka	b a t a m b o l a k a |
batamboli	b a t a m b o l i |
batanga	b a t a n g a |
batangaka	b a t a n g a k a |
batangela	b a t a n g e l a |
batangi	b a t a n g i |
batango	b a t a n g o |
batata	b a t a t a |
bateka	b a t e k a |
batekaki	b a t e k a k i |
bateke	b a t e k e |
bateki	b a t e k i |
batela	b a t e l a |
batelema	b a t e l e m a |
batelemaki	b a t e l e m a k i |
batelemi	b a t e l e m i |
batenue	b a t e n u e |
bathese	b a t h e s e |
baticket	b a t i c k e t |
batie	b a t i e |
batielaka	b a t i e l a k a |
batiene	b a t i e n e |
batika	b a t i k a |
batikala	b a t i k a l a |
batikalaki	b a t i k a l a k i |
batikali	b a t i k a l i |
batikanaki	b a t i k a n a k i |
batikeli	b a t i k e l i |
batiki	b a t i k i |
batindaka	b a t i n d a k a |
batindaki	b a t i n d a k i |
batindeli	b a t i n d e l i |
batindi	b a t i n d i |
batintin	b a t i n t i n |
batiya	b a t i y a |
bato	b a t o |
batokaka	b a t o k a k a |
batomboki	b a t o m b o k i |
batombola	b a t o m b o l a |
batomboli	b a t o m b o l i |
batondaka	b a t o n d a k a |
batondaki	b a t o n d a k i |
batondeli	b a t o n d e l i |
batonga	b a t o n g a |
batongi	b a t o n g i |
batosa	b a t o s a |
batouriste	b a t o u r i s t e |
batours	b a t o u r s |
batu	b a t u |
batuni	b a t u n i |
batɔnga	b a t ɔ n g a |
bauniversites	b a u n i v e r s i t e s |
bavedette	b a v e d e t t e |
baverifier	b a v e r i f i e r |
bavieux	b a v i e u x |
bavilla	b a v i l l a |
baville	b a v i l l e |
bavoisin	b a v o i s i n |
bavote	b a v o t e |
bawei	b a w e i |
baweleli	b a w e l e l i |
bawumbu	b a w u m b u |
bawuta	b a w u t a |
bawutaka	b a w u t a k a |
bawuti	b a w u t i |
bawɛnzɛ	b a w ɛ n z ɛ |
baya	b a y a |
bayaka	b a y a k a |
bayaki	b a y a k i |
bayambaka	b a y a m b a k a |
bayambani	b a y a m b a n i |
bayanke	b a y a n k e |
bayaya	b a y a y a |
baye	b a y e |
bayeba	b a y e b a |
bayebaka	b a y e b a k a |
bayebaki	b a y e b a k i |
bayebana	b a y e b a n a |
bayebanaki	b a y e b a n a k i |
bayebi	b a y e b i |
bayebisa	b a y e b i s a |
bayebisaki	b a y e b i s a k i |
bayebisi	b a y e b i s i |
bayei	b a y e i |
bayekoli	b a y e k o l i |
bayele	b a y e l e |
bayemba	b a y e m b a |
bayembi	b a y e m b i |
bayiamerika	b a y i a m e r i k a |
bayimolato	b a y i m o l a t o |
bayindo	b a y i n d o |
bayinigeria	b a y i n i g e r i a |
bayirwanda	b a y i r w a n d a |
bayoka	b a y o k a |
bayokaki	b a y o k a k i |
bayokani	b a y o k a n i |
bayoki	b a y o k i |
bayuma	b a y u m a |
baza	b a z a |
bazadio	b a z a d i o |
bazairois	b a z a i r o i s |
bazalaka	b a z a l a k a |
bazalaki	b a z a l a k i |
bazali	b a z a l i |
bazangaka	b a z a n g a k a |
bazangaki	b a z a n g a k i |
bazangi	b a z a n g i |
bazelaka	b a z e l a k a |
bazelaki	b a z e l a k i |
bazeli	b a z e l i |
bazinda	b a z i n d a |
bazingi	b a z i n g i |
bazokosa	b a z o k o s a |
bazolandalanda	b a z o l a n d a l a n d a |
bazonga	b a z o n g a |
bazongi	b a z o n g i |
bazongisa	b a z o n g i s a |
bazongisi	b a z o n g i s i |
bazotia	b a z o t i a |
bazoyoka	b a z o y o k a |
bazuzi	b a z u z i |
bazwa	b a z w a |
bazwaka	b a z w a k a |
bazwi	b a z w i |
bea	b e a |
beach	b e a c h |
bebe	b e b e |
bebo	b e b o |
belges	b e l g e s |
belgique	b e l g i q u e |
beljiki	b e l j i k i |
benda	b e n d a |
beni	b e n i |
beta	b e t a |
beton	b e t o n |
bibandi	b i b a n d i |
bibatelanzoto	b i b a t e l a n z o t o |
bibembe	b i b e m b e |
bible	b i b l e |
bibonga	b i b o n g a |
bibotu	b i b o t u |
bien	b i e n |
bienvenu	b i e n v e n u |
biki	b i k i |
bikila	b i k i l a |
bikotakota	b i k o t a k o t a |
bil	b i l |
bilamba	b i l a m b a |
bilanga	b i l a n g a |
bilege	b i l e g e |
bilei	b i l e i |
bileko	b i l e k o |
bilembo	b i l e m b o |
bilili	b i l i l i |
billet	b i l l e t |
bilongi	b i l o n g i |
bilɔkɔ	b i l ɔ k ɔ |
bilɛlɔ	b i l ɛ l ɔ |
bilɛngɛ	b i l ɛ n g ɛ |
bilɛngɛbasi	b i l ɛ n g ɛ b a s i |
bindre	b i n d r e |
bingambe	b i n g a m b e |
bino	b i n o |
binso	b i n s o |
binza	b i n z a |
biovallee	b i o v a l l e e |
bipale	b i p a l e |
bipayi	b i p a y i |
bipendu	b i p e n d u |
bisambeti	b i s a m b e t i |
bisekaseka	b i s e k a s e k a |
bisi	b i s i |
bisika	b i s i k a |
biso	b i s o |
bisɛngɔ	b i s ɛ n g ɔ |
bitabe	b i t a b e |
bitalatala	b i t a l a t a l a |
bitambola	b i t a m b o l a |
biteni	b i t e n i |
bitongi	b i t o n g i |
bitumba	b i t u m b a |
bizalaki	b i z a l a k i |
bizaleli	b i z a l e l i |
blueband	b l u e b a n d |
bo	b o |
bobambi	b o b a m b i |
bobele	b o b e l e |
bobomaki	b o b o m a k i |
bobomɛla	b o b o m ɛ l a |
bobongisa	b o b o n g i s a |
boboongo	b o b o o n g o |
boboto	b o b o t o |
bobwakisi	b o b w a k i s i |
boende	b o e n d e |
bofanda	b o f a n d a |
bokabwana	b o k a b w a n a |
bokabwani	b o k a b w a n i |
bokamwani	b o k a m w a n i |
bokasa	b o k a s a |
bokataki	b o k a t a k i |
bokeyi	b o k e y i |
boki	b o k i |
bokilo	b o k i l o |
bokoki	b o k o k i |
bokolongono	b o k o l o n g o n o |
bokolɛmba	b o k o l ɛ m b a |
bokomi	b o k o m i |
bokomisa	b o k o m i s a |
bokomɛla	b o k o m ɛ l a |
bokonzi	b o k o n z i |
bokopakata	b o k o p a k a t a |
bokosilisango	b o k o s i l i s a n g o |
bokota	b o k o t a |
bokotiya	b o k o t i y a |
bokovivre	b o k o v i v r e |
bokoya	b o k o y a |
bokozala	b o k o z a l a |
bokɔnɔ	b o k ɔ n ɔ |
bokɛndaka	b o k ɛ n d a k a |
bokɛndɛ	b o k ɛ n d ɛ |
bolamu	b o l a m u |
bolimbisi	b o l i m b i s i |
bolingaki	b o l i n g a k i |
bolingani	b o l i n g a n i |
bolingi	b o l i n g i |
bolingo	b o l i n g o |
bolobaka	b o l o b a k a |
boloko	b o l o k o |
bolole	b o l o l e |
bolongwa	b o l o n g w a |
boluka	b o l u k a |
bolɛngɛ	b o l ɛ n g ɛ |
bomama	b o m a m a |
bombe	b o m b e |
bomemelaka	b o m e m e l a k a |
bomesana	b o m e s a n a |
bomiyebi	b o m i y e b i |
bomobali	b o m o b a l i |
bomoi	b o m o i |
bomona	b o m o n a |
bomoni	b o m o n i |
bomoyi	b o m o y i |
bomwana	b o m w a n a |
bomwasi	b o m w a s i |
bomɔtɔ	b o m ɔ t ɔ |
bon	b o n |
bondeko	b o n d e k o |
bongo	b o n g o |
boni	b o n i |
bonso	b o n s o |
bonzenga	b o n z e n g a |
boongo	b o o n g o |
bopete	b o p e t e |
bopeto	b o p e t o |
bopotani	b o p o t a n i |
bopoti	b o p o t i |
bord	b o r d |
bosalaka	b o s a l a k a |
bosalaki	b o s a l a k i |
bosana	b o s a n a |
bosi	b o s i |
bosilani	b o s i l a n i |
bosimbi	b o s i m b i |
bosɔtɔ	b o s ɔ t ɔ |
botalaka	b o t a l a k a |
botamboli	b o t a m b o l i |
botango	b o t a n g o |
botata	b o t a t a |
boteki	b o t e k i |
botiki	b o t i k i |
botimola	b o t i m o l a |
botingameli	b o t i n g a m e l i |
botosi	b o t o s i |
botutu	b o t u t u |
bouder	b o u d e r |
boule	b o u l e |
boulevard	b o u l e v a r d |
bowanganaka	b o w a n g a n a k a |
boya	b o y a |
boyangeli	b o y a n g e l i |
boye	b o y e |
boyeba	b o y e b a |
boyebaka	b o y e b a k a |
boyebi	b o y e b i |
boyei	b o y e i |
boyi	b o y i |
boymacon	b o y m a c o n |
boyoka	b o y o k a |
boyokaka	b o y o k a k a |
boza	b o z a |
bozalaka	b o z a l a k a |
bozali	b o z a l i |
bozanga	b o z a n g a |
bozangaka	b o z a n g a k a |
bozela	b o z e l a |
bozoba	b o z o b a |
bozonga	b o z o n g a |
bozongi	b o z o n g i |
bozoyiba	b o z o y i b a |
bozwa	b o z w a |
bozwaki	b o z w a k i |
brazza	b r a z z a |
brazzaville	b r a z z a v i l l e |
brique	b r i q u e |
briques	b r i q u e s |
brown	b r o w n |
bruxelles	b r u x e l l e s |
bsrs	b s r s |
bukavu	b u k a v u |
bukayi	b u k a y i |
bureau	b u r e a u |
bus	b u s |
busalaud	b u s a l a u d |
bush	b u s h |
buta	b u t a |
butu	b u t u |
bwa	b w a |
bwala	b w a l a |
bwale	b w a l e |
ca	c a |
cachot	c a c h o t |
cafe	c a f e |
cailloux	c a i l l o u x |
calecon	c a l e c o n |
calme	c a l m e |
camarade	c a m a r a d e |
camera	c a m e r a |
camp	c a m p |
campagne	c a m p a g n e |
campus	c a m p u s |
candidat	c a n d i d a t |
capitaine	c a p i t a i n e |
carnet	c a r n e t |
casier	c a s i e r |
causer	c a u s e r |
cavale	c a v a l e |
ce	c e |
cent	c e n t |
centcent	c e n t c e n t |
centre	c e n t r e |
centreville	c e n t r e v i l l e |
certificat	c e r t i f i c a t |
cesar	c e s a r |
cfa	c f a |
chambre	c h a m b r e |
chance	c h a n c e |
chantier	c h a n t i e r |
charleroi	c h a r l e r o i |
charlie	c h a r l i e |
chef	c h e f |
chemise	c h e m i s e |
cher	c h e r |
cherche	c h e r c h e |
chercheur	c h e r c h e u r |
cherie	c h e r i e |
chez	c h e z |
chimiste	c h i m i s t e |
chine	c h i n e |
christelle	c h r i s t e l l e |
christian	c h r i s t i a n |
ciment	c i m e n t |
cimetiere	c i m e t i e r e |
cinq	c i n q |
circuit	c i r c u i t |
citoyen	c i t o y e n |
clandestin	c l a n d e s t i n |
client	c l i e n t |
cliniques	c l i n i q u e s |
code	c o d e |
coin	c o i n |
col	c o l |
commande	c o m m a n d e |
commando	c o m m a n d o |
comme	c o m m e |
comment	c o m m e n t |
commercant	c o m m e r c a n t |
commerciale	c o m m e r c i a l e |
commissionnaire	c o m m i s s i o n n a i r e |
compte	c o m p t e |
concentre	c o n c e n t r e |
concours	c o n c o u r s |
confiance	c o n f i a n c e |
congo	c o n g o |
congokinshasa	c o n g o k i n s h a s a |
congolais	c o n g o l a i s |
conseil	c o n s e i l |
contact	c o n t a c t |
contre	c o n t r e |
coop	c o o p |
coopango	c o o p a n g o |
cote	c o t e |
couleur	c o u l e u r |
couloir	c o u l o i r |
coup	c o u p |
courage	c o u r a g e |
courageux	c o u r a g e u x |
courant	c o u r a n t |
crane	c r a n e |
creche	c r e c h e |
crise	c r i s e |
croix	c r o i x |
croixrouge	c r o i x r o u g e |
cuir	c u i r |
cure	c u r e |
daba	d a b a |
daccouchement	d a c c o u c h e m e n t |
dahan	d a h a n |
dailleurs	d a i l l e u r s |
dais	d a i s |
dako	d a k o |
dam	d a m |
dame	d a m e |
dammage	d a m m a g e |
danki	d a n k i |
dans	d a n s |
danse	d a n s e |
danze	d a n z e |
dasile	d a s i l e |
de	d e |
deception	d e c e p t i o n |
defile	d e f i l e |
deja	d e j a |
demande	d e m a n d e |
demandeur	d e m a n d e u r |
dembo	d e m b o |
dendal	d e n d a l |
depot	d e p o t |
depuis	d e p u i s |
depute	d e p u t e |
des	d e s |
detat	d e t a t |
deux	d e u x |
dgm	d g m |
dhygiene	d h y g i e n e |
diamant	d i a m a n t |
diamba	d i a m b a |
dici	d i c i |
die	d i e |
difference	d i f f e r e n c e |
dikosi	d i k o s i |
diplome	d i p l o m e |
dirait	d i r a i t |
directeur	d i r e c t e u r |
dit	d i t |
dix	d i x |
dixneuve	d i x n e u v e |
djalɛlɔ	d j a l ɛ l ɔ |
djef	d j e f |
djibril	d j i b r i l |
djo	d j o |
doctorat	d o c t o r a t |
dolar	d o l a r |
dolare	d o l a r e |
dollar	d o l l a r |
dollars	d o l l a r s |
donc	d o n c |
dongolomiso	d o n g o l o m i s o |
dossier	d o s s i e r |
drogue	d r o g u e |
droit	d r o i t |
du	d u |
e	e |
ebakata	e b a k a t a |
ebale	e b a l e |
ebaluki	e b a l u k i |
ebalusaki	e b a l u s a k i |
ebanda	e b a n d a |
ebandaka	e b a n d a k a |
ebandakaki	e b a n d a k a k i |
ebandaki	e b a n d a k i |
ebandeli	e b a n d e l i |
ebandi	e b a n d i |
ebayisa	e b a y i s a |
ebeba	e b e b a |
ebebaka	e b e b a k a |
ebebaki	e b e b a k i |
ebelaki	e b e l a k i |
ebele	e b e l e |
ebelisaka	e b e l i s a k a |
ebembe	e b e m b e |
ebenga	e b e n g a |
ebengana	e b e n g a n a |
ebengi	e b e n g i |
ebeta	e b e t a |
ebetama	e b e t a m a |
ebeti	e b e t i |
ebima	e b i m a |
ebimaka	e b i m a k a |
ebimaki	e b i m a k i |
ebimeli	e b i m e l i |
ebimi	e b i m i |
ebimisaki	e b i m i s a k i |
eboke	e b o k e |
ebola	e b o l a |
eboma	e b o m a |
ebonga	e b o n g a |
ebongaki	e b o n g a k i |
ebongi	e b o n g i |
ebongo	e b o n g o |
ebongwana	e b o n g w a n a |
ebongwanaki	e b o n g w a n a k i |
ebongwani	e b o n g w a n i |
ebonzeli	e b o n z e l i |
ebosanisaki	e b o s a n i s a k i |
ebukanaki	e b u k a n a k i |
ebuki	e b u k i |
ebungi	e b u n g i |
ebwaka	e b w a k a |
echanger	e c h a n g e r |
ecole	e c o l e |
economierurale	e c o n o m i e r u r a l e |
ecran	e c r a n |
ecriture	e c r i t u r e |
editions	e d i t i o n s |
ee	e e |
eeeh	e e e h |
efandaka	e f a n d a k a |
effort	e f f o r t |
efuku	e f u k u |
efungwamaki	e f u n g w a m a k i |
efungwami	e f u n g w a m i |
efutaka	e f u t a k a |
egangaki	e g a n g a k i |
egengaka	e g e n g a k a |
ekabolaka	e k a b o l a k a |
ekaboli	e k a b o l i |
ekala	e k a l a |
ekangaki	e k a n g a k i |
ekangama	e k a n g a m a |
ekangamakangama	e k a n g a m a k a n g a m a |
ekangami	e k a n g a m i |
ekangi	e k a n g i |
ekatana	e k a t a n a |
ekati	e k a t i |
ekei	e k e i |
ekeko	e k e k o |
ekenge	e k e n g e |
ekeyi	e k e y i |
ekimi	e k i m i |
ekipaka	e k i p a k a |
ekita	e k i t a |
ekiti	e k i t i |
ekobela	e k o b e l a |
ekobima	e k o b i m a |
ekobimisa	e k o b i m i s a |
ekobinisa	e k o b i n i s a |
ekobonga	e k o b o n g a |
ekobosana	e k o b o s a n a |
ekoka	e k o k a |
ekokabola	e k o k a b o l a |
ekokaka	e k o k a k a |
ekokaki	e k o k a k i |
ekokana	e k o k a n a |
ekokani	e k o k a n i |
ekoki	e k o k i |
ekokitisa	e k o k i t i s a |
ekokoka	e k o k o k a |
ekokoma	e k o k o m a |
ekokomisa	e k o k o m i s a |
ekokɛndɛ	e k o k ɛ n d ɛ |
ekolaki	e k o l a k i |
ekolo	e k o l o |
ekoma	e k o m a |
ekomaka	e k o m a k a |
ekomaki	e k o m a k i |
ekomeli	e k o m e l i |
ekomi	e k o m i |
ekomisa	e k o m i s a |
ekomisaka	e k o m i s a k a |
ekomonana	e k o m o n a n a |
ekondingisa	e k o n d i n g i s a |
ekonzo	e k o n z o |
ekopesa	e k o p e s a |
ekosala	e k o s a l a |
ekosema	e k o s e m a |
ekosenga	e k o s e n g a |
ekosila	e k o s i l a |
ekosimba	e k o s i m b a |
ekosopa	e k o s o p a |
ekosopana	e k o s o p a n a |
ekosuka	e k o s u k a |
ekosukela	e k o s u k e l a |
ekotaka	e k o t a k a |
ekotaki	e k o t a k i |
ekotekama	e k o t e k a m a |
ekoteli	e k o t e l i |
ekoti	e k o t i |
ekowuta	e k o w u t a |
ekoya	e k o y a |
ekoyembama	e k o y e m b a m a |
ekoyokana	e k o y o k a n a |
ekozala	e k o z a l a |
ekozwa	e k o z w a |
ekufa	e k u f a |
ekuke	e k u k e |
ekutaka	e k u t a k a |
ekutana	e k u t a n a |
ekutanaka	e k u t a n a k a |
ekweya	e k w e y a |
ekweyaki	e k w e y a k i |
ekɛnda	e k ɛ n d a |
ekɛndaki	e k ɛ n d a k i |
ekɛndɛ	e k ɛ n d ɛ |
ekɛndɛki	e k ɛ n d ɛ k i |
elaka	e l a k a |
elakisaka	e l a k i s a k a |
elakisi	e l a k i s i |
elali	e l a l i |
elalisaka	e l a l i s a k a |
elamba	e l a m b a |
elambo	e l a m b o |
elandaka	e l a n d a k a |
elandaki	e l a n d a k i |
elandi	e l a n d i |
elata	e l a t a |
elateli	e l a t e l i |
eleka	e l e k a |
elekaka	e l e k a k a |
elekaki	e l e k a k i |
elekanaka	e l e k a n a k a |
elekanaki	e l e k a n a k i |
eleki	e l e k i |
eleko	e l e k o |
elema	e l e m a |
elembisaki	e l e m b i s a k i |
eliaki	e l i a k i |
eliamaka	e l i a m a k a |
eliezer	e l i e z e r |
elikya	e l i k y a |
elima	e l i m a |
elingaki	e l i n g a k i |
elingi	e l i n g i |
elobaka	e l o b a k a |
elobeli	e l o b e l i |
elonga	e l o n g a |
elongi	e l o n g i |
elongo	e l o n g o |
elongola	e l o n g o l a |
elongwa	e l o n g w a |
elongwe	e l o n g w e |
elooko	e l o o k o |
elulu	e l u l u |
eluta	e l u t a |
elɔkɔ	e l ɔ k ɔ |
elɔkɔteli	e l ɔ k ɔ t e l i |
elɛngi	e l ɛ n g i |
elɛngɛ	e l ɛ n g ɛ |
elɛngɛlamaki	e l ɛ n g ɛ l a m a k i |
emateli	e m a t e l i |
emati	e m a t i |
embana	e m b a n a |
embrouillement	e m b r o u i l l e m e n t |
emeki	e m e k i |
emelaka	e m e l a k a |
ememaka	e m e m a k a |
emesana	e m e s a n a |
emission	e m i s s i o n |
emonanaka	e m o n a n a k a |
emonani	e m o n a n i |
emɛlamaka	e m ɛ l a m a k a |
en	e n |
endimi	e n d i m i |
enfous	e n f o u s |
engambe	e n g a m b e |
engumba	e n g u m b a |
engumbamokonzi	e n g u m b a m o k o n z i |
eninganaki	e n i n g a n a k i |
eningani	e n i n g a n i |
entre	e n t r e |
entretemps	e n t r e t e m p s |
enzɔmbɔ	e n z ɔ m b ɔ |
epaka	e p a k a |
epanzanaki	e p a n z a n a k i |
epayi	e p a y i |
epemelo	e p e m e l o |
epesa	e p e s a |
epesaka	e p e s a k a |
epesela	e p e s e l a |
epesi	e p e s i |
eponi	e p o n i |
epumbuki	e p u m b u k i |
epumbwi	e p u m b w i |
erataka	e r a t a k a |
esakola	e s a k o l a |
esala	e s a l a |
esalaka	e s a l a k a |
esalaki	e s a l a k i |
esalamaka	e s a l a m a k a |
esalamaki	e s a l a m a k i |
esalami	e s a l a m i |
esalemaka	e s a l e m a k a |
esalemi	e s a l e m i |
esali	e s a l i |
esanga	e s a n g a |
esangani	e s a n g a n i |
esangisaki	e s a n g i s a k i |
escaliers	e s c a l i e r s |
esekeli	e s e k e l i |
esemi	e s e m i |
esengaka	e s e n g a k a |
esengelaki	e s e n g e l a k i |
esengeleki	e s e n g e l e k i |
esengeli	e s e n g e l i |
esengi	e s e n g i |
esi	e s i |
esika	e s i k a |
esila	e s i l a |
esilaka	e s i l a k a |
esilaki	e s i l a k i |
esili	e s i l i |
esilisi	e s i l i s i |
esimba	e s i m b a |
esimbaki	e s i m b a k i |
esopani	e s o p a n i |
esprit	e s p r i t |
est	e s t |
estce	e s t c e |
esukaki	e s u k a k i |
esuki	e s u k i |
esulungutu	e s u l u n g u t u |
esunda	e s u n d a |
esungaka	e s u n g a k a |
esɔsɔlaki	e s ɔ s ɔ l a k i |
esɛngɔ	e s ɛ n g ɔ |
et	e t |
etage	e t a g e |
etali	e t a l i |
etambola	e t a m b o l a |
etambolaka	e t a m b o l a k a |
etamboli	e t a m b o l i |
etana	e t a n a |
etangama	e t a n g a m a |
ete	e t e |
etekamaka	e t e k a m a k a |
etekami	e t e k a m i |
etelemaki	e t e l e m a k i |
etelemelo	e t e l e m e l o |
etelemi	e t e l e m i |
eteyelo	e t e y e l o |
etikala	e t i k a l a |
etikalaka	e t i k a l a k a |
etikalaki	e t i k a l a k i |
etikali	e t i k a l i |
etinda	e t i n d a |
etindaki	e t i n d a k i |
etindamalili	e t i n d a m a l i l i |
etiya	e t i y a |
etokisaki	e t o k i s a k i |
etonda	e t o n d a |
etondaka	e t o n d a k a |
etondaki	e t o n d a k i |
etondi	e t o n d i |
etongama	e t o n g a m a |
etrangers	e t r a n g e r s |
etudiant	e t u d i a n t |
etumba	e t u m b a |
etungisaki	e t u n g i s a k i |
etuni	e t u n i |
etyɔla	e t y ɔ l a |
etɔnga	e t ɔ n g a |
ewumelaka	e w u m e l a k a |
ewumelaki	e w u m e l a k i |
ewumeli	e w u m e l i |
ewuta	e w u t a |
ewutaka	e w u t a k a |
ewutaki	e w u t a k i |
ewuti	e w u t i |
excellence	e x c e l l e n c e |
excursion	e x c u r s i o n |
exellence	e x e l l e n c e |
exetat	e x e t a t |
exode	e x o d e |
extrait	e x t r a i t |
eya	e y a |
eyaka	e y a k a |
eyaki	e y a k i |
eyano	e y a n o |
eye	e y e |
eyebana	e y e b a n a |
eyebanaka	e y e b a n a k a |
eyebanaki	e y e b a n a k i |
eyebi	e y e b i |
eyelaka	e y e l a k a |
eyeli	e y e l i |
eyemba	e y e m b a |
eyenga	e y e n g a |
eyindi	e y i n d i |
eyindisaki	e y i n d i s a k i |
eyinelo	e y i n e l o |
eyingela	e y i n g e l a |
eyokaki	e y o k a k i |
eyoki	e y o k i |
eza	e z a |
ezala	e z a l a |
ezalaka	e z a l a k a |
ezalaki	e z a l a k i |
ezali	e z a l i |
ezanga	e z a n g a |
ezangaka	e z a n g a k a |
ezangi	e z a n g i |
ezipi	e z i p i |
ezoboma	e z o b o m a |
ezokaki	e z o k a k i |
ezonga	e z o n g a |
ezongaka	e z o n g a k a |
ezongaki	e z o n g a k i |
ezonganga	e z o n g a n g a |
ezongeli	e z o n g e l i |
ezongi	e z o n g i |
ezosala	e z o s a l a |
ezosalama	e z o s a l a m a |
ezosenga	e z o s e n g a |
ezosilisa	e z o s i l i s a |
ezotala	e z o t a l a |
ezwaka	e z w a k a |
ezwama	e z w a m a |
ezwamaki	e z w a m a k i |
ezwi	e z w i |
face	f a c e |
facilement	f a c i l e m e n t |
fallait	f a l l a i t |
famille	f a m i l l e |
fanda	f a n d a |
farde	f a r d e |
faut	f a u t |
faux	f a u x |
faze	f a z e |
felice	f e l i c e |
ferme	f e r m e |
feti	f e t i |
feuille	f e u i l l e |
filipo	f i l i p o |
film	f i l m |
fimbu	f i m b u |
finalement	f i n a l e m e n t |
fkm	f k m |
folie	f o l i e |
folis	f o l i s |
forman	f o r m a n |
forraine	f o r r a i n e |
foto	f o t o |
fou	f o u |
franc	f r a n c |
francais	f r a n c a i s |
france	f r a n c e |
francs	f r a n c s |
fufu	f u f u |
fulu	f u l u |
fungola	f u n g o l a |
fwa	f w a |
fwakumputu	f w a k u m p u t u |
gaillard	g a i l l a r d |
galerie	g a l e r i e |
gambela	g a m b e l a |
garantie	g a r a n t i e |
garcon	g a r c o n |
gare	g a r e |
gauche	g a u c h e |
gbi	g b i |
gendarmerie	g e n d a r m e r i e |
general	g e n e r a l |
genomique	g e n o m i q u e |
geoges	g e o g e s |
georges	g e o r g e s |
gobelet	g o b e l e t |
godi	g o d i |
goma	g o m a |
gombe	g o m b e |
gombo	g o m b o |
goubald	g o u b a l d |
gouffre	g o u f f r e |
gouvernement	g o u v e r n e m e n t |
grand	g r a n d |
greve	g r e v e |
griffe	g r i f f e |
grimace	g r i m a c e |
gros	g r o s |
gubegube	g u b e g u b e |
guichet	g u i c h e t |
guvernema	g u v e r n e m a |
gynecologue	g y n e c o l o g u e |
he	h e |
hein	h e i n |
heure	h e u r e |
heureango	h e u r e a n g o |
heures	h e u r e s |
histoire	h i s t o i r e |
hollande	h o l l a n d e |
honorable	h o n o r a b l e |
hopital	h o p i t a l |
horloge	h o r l o g e |
hotel	h o t e l |
hussein	h u s s e i n |
idiofa	i d i o f a |
il	i l |
immeuble	i m m e u b l e |
influence	i n f l u e n c e |
initiative	i n i t i a t i v e |
inso	i n s o |
institut	i n s t i t u t |
interro	i n t e r r o |
invitation	i n v i t a t i o n |
isc	i s c |
ituri	i t u r i |
james	j a m e s |
je	j e |
jean	j e a n |
jeannine	j e a n n i n e |
jeans	j e a n s |
jeep	j e e p |
jeu	j e u |
jeune	j e u n e |
jeux	j e u x |
joseph	j o s e p h |
josephine	j o s e p h i n e |
joueur	j o u e u r |
journaliste	j o u r n a l i s t e |
jours	j o u r s |
judiciaire	j u d i c i a i r e |
juin	j u i n |
juve	j u v e |
kabakata	k a b a k a t a |
kabambare	k a b a m b a r e |
kabambi	k a b a m b i |
kabila	k a b i l a |
kaddhafi	k a d d h a f i |
kaka	k a k a |
kala	k a l a |
kalaka	k a l a k a |
kalamu	k a l a m u |
kali	k a l i |
kalina	k a l i n a |
kalle	k a l l e |
kambaki	k a m b a k i |
kameleon	k a m e l e o n |
kamerun	k a m e r u n |
kamwa	k a m w a |
kana	k a n a |
kanda	k a n d a |
kanga	k a n g a |
kanisa	k a n i s a |
kanyaka	k a n y a k a |
kanzaku	k a n z a k u |
karateka	k a r a t e k a |
kasayi	k a s a y i |
kasi	k a s i |
kata	k a t a |
kati	k a t i |
katikati	k a t i k a t i |
kato	k a t o |
kayina	k a y i n a |
kazaka	k a z a k a |
ke	k e |
keba	k e b a |
kelasi	k e l a s i |
kenya	k e n y a |
kesi	k e s i |
ketch	k e t c h |
kibokonzi	k i b o k o n z i |
kibolabola	k i b o l a b o l a |
kibolole	k i b o l o l e |
kibotata	k i b o t a t a |
kicherche	k i c h e r c h e |
kidumba	k i d u m b a |
kiexcellence	k i e x c e l l e n c e |
kifwafwa	k i f w a f w a |
kigangi	k i g a n g i |
kihonorable	k i h o n o r a b l e |
kikuku	k i k u k u |
kikwit	k i k w i t |
kilawu	k i l a w u |
kili	k i l i |
kilikili	k i l i k i l i |
kilo	k i l o |
kimia	k i m i a |
kimmbangu	k i m m b a n g u |
kimobali	k i m o b a l i |
kimoyibi	k i m o y i b i |
kimpa	k i m p a |
kimpangu	k i m p a n g u |
kimpwanza	k i m p w a n z a |
kimukolo	k i m u k o l o |
kimya	k i m y a |
kin	k i n |
kindeko	k i n d e k o |
kindoki	k i n d o k i |
kindumba	k i n d u m b a |
kingasani	k i n g a s a n i |
kingo	k i n g o |
kingoma	k i n g o m a |
kingunda	k i n g u n d a |
kino	k i n o |
kinoise	k i n o i s e |
kinshasa	k i n s h a s a |
kintambo	k i n t a m b o |
kinzonzi	k i n z o n z i |
kipe	k i p e |
kipelekese	k i p e l e k e s e |
kipiki	k i p i k i |
kisasa	k i s a s a |
kisi	k i s i |
kisinzili	k i s i n z i l i |
kitalatala	k i t a l a t a l a |
kitambala	k i t a m b a l a |
kitega	k i t e g a |
kitendi	k i t e n d i |
kiti	k i t i |
kitisa	k i t i s a |
kitoko	k i t o k o |
kitooko	k i t o o k o |
kitota	k i t o t a |
kivu	k i v u |
kiyanke	k i y a n k e |
kizunguzungu	k i z u n g u z u n g u |
klando	k l a n d o |
ko	k o |
koaider	k o a i d e r |
koanimer	k o a n i m e r |
koba	k o b a |
kobaka	k o b a k a |
kobakisela	k o b a k i s e l a |
kobala	k o b a l a |
kobalana	k o b a l a n a |
kobaluka	k o b a l u k a |
kobalukela	k o b a l u k e l a |
kobanda	k o b a n d a |
kobandela	k o b a n d e l a |
kobanga	k o b a n g a |
kobangabanga	k o b a n g a b a n g a |
kobangela	k o b a n g e l a |
kobangisa	k o b a n g i s a |
kobanza	k o b a n z a |
kobatama	k o b a t a m a |
kobatela	k o b a t e l a |
kobaye	k o b a y e |
kobeba	k o b e b a |
kobebisa	k o b e b i s a |
kobela	k o b e l a |
kobelela	k o b e l e l a |
kobenda	k o b e n d a |
kobenga	k o b e n g a |
kobengana	k o b e n g a n a |
kobeta	k o b e t a |
kobetama	k o b e t a m a |
kobetana	k o b e t a n a |
kobetela	k o b e t e l a |
kobikisa	k o b i k i s a |
kobima	k o b i m a |
kobimisa	k o b i m i s a |
kobina	k o b i n a |
kobinisa	k o b i n i s a |
kobokwama	k o b o k w a m a |
koboma	k o b o m a |
kobomana	k o b o m a n a |
kobomba	k o b o m b a |
kobombela	k o b o m b e l a |
kobondela	k o b o n d e l a |
kobongisa	k o b o n g i s a |
kobongola	k o b o n g o l a |
kobonza	k o b o n z a |
kobosana	k o b o s a n a |
kobosanaka	k o b o s a n a k a |
kobota	k o b o t a |
kobotama	k o b o t a m a |
koboya	k o b o y a |
kobuka	k o b u k a |
kobunda	k o b u n d a |
kobundana	k o b u n d a n a |
kobundela	k o b u n d e l a |
kobwaka	k o b w a k a |
kobwakama	k o b w a k a m a |
kobɔtɔlɔ	k o b ɔ t ɔ l ɔ |
kocomprendre	k o c o m p r e n d r e |
kocompter	k o c o m p t e r |
kocorriger	k o c o r r i g e r |
kodamer	k o d a m e r |
kodefa	k o d e f a |
kodie	k o d i e |
kodiongo	k o d i o n g o |
kodiriger	k o d i r i g e r |
kodiscuter	k o d i s c u t e r |
koengager	k o e n g a g e r |
koeviter	k o e v i t e r |
koexpliquer	k o e x p l i q u e r |
kofanda	k o f a n d a |
kofandaka	k o f a n d a k a |
kofazer	k o f a z e r |
koffi	k o f f i |
kofina	k o f i n a |
kofinga	k o f i n g a |
kofungola	k o f u n g o l a |
kofungwama	k o f u n g w a m a |
kofuta	k o f u t a |
kofutaka	k o f u t a k a |
kofutela	k o f u t e l a |
koganga	k o g a n g a |
kogenga	k o g e n g a |
kokabola	k o k a b o l a |
kokabolela	k o k a b o l e l a |
kokabwana	k o k a b w a n a |
kokamwa	k o k a m w a |
kokana	k o k a n a |
kokanga	k o k a n g a |
kokangama	k o k a n g a m a |
kokanisa	k o k a n i s a |
kokata	k o k a t a |
kokawuka	k o k a w u k a |
kokemba	k o k e m b a |
kokima	k o k i m a |
kokipe	k o k i p e |
kokita	k o k i t a |
kokitisa	k o k i t i s a |
koko	k o k o |
kokoba	k o k o b a |
kokoka	k o k o k a |
kokola	k o k o l a |
kokolisa	k o k o l i s a |
kokoma	k o k o m a |
kokomaka	k o k o m a k a |
kokomba	k o k o m b a |
kokomɛla	k o k o m ɛ l a |
kokosa	k o k o s a |
kokoso	k o k o s o |
kokota	k o k o t a |
kokotisa	k o k o t i s a |
kokufa	k o k u f a |
kokumba	k o k u m b a |
kokumisa	k o k u m i s a |
kokunda	k o k u n d a |
kokuta	k o k u t a |
kokutana	k o k u t a n a |
kokweisama	k o k w e i s a m a |
kokweya	k o k w e y a |
kokɔmbɔla	k o k ɔ m b ɔ l a |
kokɛnda	k o k ɛ n d a |
kokɛndaka	k o k ɛ n d a k a |
kokɛndɛ	k o k ɛ n d ɛ |
kokɛngɛla	k o k ɛ n g ɛ l a |
kolakisa	k o l a k i s a |
kolala	k o l a l a |
kolamba	k o l a m b a |
kolamuka	k o l a m u k a |
kolanda	k o l a n d a |
kolandana	k o l a n d a n a |
kolandela	k o l a n d e l a |
kolangwisa	k o l a n g w i s a |
kolata	k o l a t a |
koleisa	k o l e i s a |
koleka	k o l e k a |
kolekaleka	k o l e k a l e k a |
kolekana	k o l e k a n a |
kolekela	k o l e k e l a |
kolekisa	k o l e k i s a |
kolela	k o l e l a |
kolelaka	k o l e l a k a |
kolendisa	k o l e n d i s a |
kolia	k o l i a |
kolinga	k o l i n g a |
kolingama	k o l i n g a m a |
kolingana	k o l i n g a n a |
koliya	k o l i y a |
kolo	k o l o |
koloba	k o l o b a |
kolobaka	k o l o b a k a |
kolobela	k o l o b e l a |
koloka	k o l o k a |
kolokota	k o l o k o t a |
kolongisa	k o l o n g i s a |
kolongola	k o l o n g o l a |
kolota	k o l o t a |
koltani	k o l t a n i |
koluka	k o l u k a |
kolukela	k o l u k e l a |
kolula	k o l u l a |
kolɛmba	k o l ɛ m b a |
kolɛngɛla	k o l ɛ n g ɛ l a |
komata	k o m a t a |
kombekombe	k o m b e k o m b e |
kombo	k o m b o |
komeka	k o m e k a |
komema	k o m e m a |
komemela	k o m e m e l a |
komikitisa	k o m i k i t i s a |
komikotisa	k o m i k o t i s a |
komilobela	k o m i l o b e l a |
komilɛngɛla	k o m i l ɛ n g ɛ l a |
komimona	k o m i m o n a |
komitala	k o m i t a l a |
komitiya	k o m i t i y a |
komituna	k o m i t u n a |
komitungisa	k o m i t u n g i s a |
komiyokela	k o m i y o k e l a |
komona	k o m o n a |
komonaka	k o m o n a k a |
komonana	k o m o n a n a |
komonisa	k o m o n i s a |
komonisama	k o m o n i s a m a |
kompani	k o m p a n i |
kompanyi	k o m p a n y i |
komystike	k o m y s t i k e |
komystique	k o m y s t i q u e |
komɛla	k o m ɛ l a |
kondima	k o n d i m a |
kongala	k o n g a l a |
kongenga	k o n g e n g a |
kongo	k o n g o |
koningana	k o n i n g a n a |
konyɔkola	k o n y ɔ k o l a |
konyɔkwama	k o n y ɔ k w a m a |
konyɔlisa	k o n y ɔ l i s a |
konyɔngama	k o n y ɔ n g a m a |
konzo	k o n z o |
kop	k o p |
kopakola	k o p a k o l a |
kopambola	k o p a m b o l a |
kopangusa	k o p a n g u s a |
kopekisa	k o p e k i s a |
kopema	k o p e m a |
kopemisa	k o p e m i s a |
kopepa	k o p e p a |
kopesa	k o p e s a |
kopo	k o p o |
kopomper	k o p o m p e r |
kopota	k o p o t a |
kopreparer	k o p r e p a r e r |
kopumbwa	k o p u m b w a |
kopusana	k o p u s a n a |
koregretter	k o r e g r e t t e r |
kosakana	k o s a k a n a |
kosakola	k o s a k o l a |
kosala	k o s a l a |
kosalama	k o s a l a m a |
kosalela	k o s a l e l a |
kosalisa	k o s a l i s a |
kosambela	k o s a m b e l a |
kosambisa	k o s a m b i s a |
kosambwisa	k o s a m b w i s a |
kosangana	k o s a n g a n a |
kosangisa	k o s a n g i s a |
koseka	k o s e k a |
kosekisa	k o s e k i s a |
kosenga	k o s e n g a |
kosepela	k o s e p e l a |
kosepelisa	k o s e p e l i s a |
kosigner	k o s i g n e r |
kosilisa	k o s i l i s a |
kosimba	k o s i m b a |
kosolola	k o s o l o l a |
kosomba	k o s o m b a |
kosombela	k o s o m b e l a |
kosopana	k o s o p a n a |
kosoutenir	k o s o u t e n i r |
kostaffer	k o s t a f f e r |
kosuba	k o s u b a |
kosuka	k o s u k a |
kosukola	k o s u k o l a |
kosukosu	k o s u k o s u |
kosunga	k o s u n g a |
kosungama	k o s u n g a m a |
kosupporter	k o s u p p o r t e r |
koswana	k o s w a n a |
kota	k o t a |
kotaka	k o t a k a |
kotala	k o t a l a |
kotalana	k o t a l a n a |
kotalisa	k o t a l i s a |
kotambola	k o t a m b o l a |
kotambolatambola	k o t a m b o l a t a m b o l a |
kotambusa	k o t a m b u s a |
kotambusama	k o t a m b u s a m a |
kotanda	k o t a n d a |
kotanga	k o t a n g a |
kotangela	k o t a n g e l a |
koteka	k o t e k a |
kotekaka	k o t e k a k a |
kotekama	k o t e k a m a |
kotekela	k o t e k e l a |
kotekisa	k o t e k i s a |
kotelema	k o t e l e m a |
kotelematelema	k o t e l e m a t e l e m a |
kotelemela	k o t e l e m e l a |
kotelengana	k o t e l e n g a n a |
kotelenganaka	k o t e l e n g a n a k a |
kotengama	k o t e n g a m a |
kotepa	k o t e p a |
kotester	k o t e s t e r |
koteya	k o t e y a |
kotiela	k o t i e l a |
kotika	k o t i k a |
kotikala	k o t i k a l a |
kotikela	k o t i k e l a |
kotimola	k o t i m o l a |
kotinda	k o t i n d a |
kotindela	k o t i n d e l a |
kotingama	k o t i n g a m a |
kotiola	k o t i o l a |
kotiya	k o t i y a |
kotkot	k o t k o t |
kotoka	k o t o k a |
kotokisa	k o t o k i s a |
kotomboka	k o t o m b o k a |
kotombola	k o t o m b o l a |
kotonda	k o t o n d a |
kotongela	k o t o n g e l a |
kotumba	k o t u m b a |
kotuna	k o t u n a |
kotunaka	k o t u n a k a |
kotungisa	k o t u n g i s a |
kotuta	k o t u t a |
kotutana	k o t u t a n a |
kotɔnga	k o t ɔ n g a |
kotɔngama	k o t ɔ n g a m a |
kovivre	k o v i v r e |
kowela	k o w e l a |
kowolola	k o w o l o l a |
koya	k o y a |
koyamba	k o y a m b a |
koyanola	k o y a n o l a |
koyeba	k o y e b a |
koyebisa	k o y e b i s a |
koyekama	k o y e k a m a |
koyela	k o y e l a |
koyiba	k o y i b a |
koyimayima	k o y i m a y i m a |
koyinda	k o y i n d a |
koyinisa	k o y i n i s a |
koyoka	k o y o k a |
koyokaka	k o y o k a k a |
koyokana	k o y o k a n a |
kozala	k o z a l a |
kozanga	k o z a n g a |
kozangisa	k o z a n g i s a |
kozela	k o z e l a |
kozinda	k o z i n d a |
kozomela	k o z o m e l a |
kozonga	k o z o n g a |
kozongisa	k o z o n g i s a |
kozwa	k o z w a |
kozwela	k o z w e l a |
kravati	k r a v a t i |
ku	k u |
kufa	k u f a |
kuluna	k u l u n a |
kulutu	k u l u t u |
kumputu	k u m p u t u |
kuna	k u n a |
kundebembe	k u n d e b e m b e |
kundulpin	k u n d u l p i n |
kunzi	k u n z i |
kurage	k u r a g e |
kutu	k u t u |
kwanga	k w a n g a |
kwani	k w a n i |
kwedi	k w e d i |
kwele	k w e l e |
kwelekwele	k w e l e k w e l e |
kwiti	k w i t i |
kɛndɛ	k ɛ n d ɛ |
la	l a |
lac	l a c |
laisser	l a i s s e r |
laisserpasser	l a i s s e r p a s s e r |
lala	l a l a |
lamuka	l a m u k a |
landa	l a n d a |
landrover	l a n d r o v e r |
langue	l a n g u e |
lar	l a r |
lata	l a t a |
le	l e |
leki	l e k i |
lekisa	l e k i s a |
lela	l e l a |
lemba	l e m b a |
lepre	l e p r e |
les	l e s |
leta	l e t a |
lhomme	l h o m m e |
libabe	l i b a b e |
libaku	l i b a k u |
libala	l i b a l a |
libanais	l i b a n a i s |
liband	l i b a n d |
libanda	l i b a n d a |
libanga	l i b a n g a |
libaya	l i b a y a |
libela	l i b e l a |
libenga	l i b e n g a |
liberte	l i b e r t e |
libiki	l i b i k i |
libiso	l i b i s o |
liboke	l i b o k e |
liboko	l i b o k o |
liboma	l i b o m a |
libonza	l i b o n z a |
liboso	l i b o s o |
libota	l i b o t a |
libre	l i b r e |
libulu	l i b u l u |
libumu	l i b u m u |
libwa	l i b w a |
licencie	l i c e n c i e |
lieu	l i e u |
lifelo	l i f e l o |
lifuta	l i f u t a |
lifuti	l i f u t i |
ligablo	l i g a b l o |
likala	l i k a l a |
likama	l i k a m a |
likambo	l i k a m b o |
likanisi	l i k a n i s i |
likaya	l i k a y a |
likayabu	l i k a y a b u |
likili	l i k i l i |
likita	l i k i t a |
likofi	l i k o f i |
likol	l i k o l |
likolo	l i k o l o |
likololikolo	l i k o l o l i k o l o |
likonda	l i k o n d a |
likonga	l i k o n g a |
likunya	l i k u n y a |
lilita	l i l i t a |
lille	l i l l e |
liloba	l i l o b a |
limbisa	l i m b i s a |
limete	l i m e t e |
lingala	l i n g a l a |
lingomba	l i n g o m b a |
lingwala	l i n g w a l a |
lingwanda	l i n g w a n d a |
linzanza	l i n z a n z a |
lipa	l i p a |
lipamboli	l i p a m b o l i |
lipapa	l i p a p a |
lipela	l i p e l a |
liputa	l i p u t a |
lisano	l i s a n o |
lisapo	l i s a p o |
lisapoonge	l i s a p o o n g e |
lisolo	l i s o l o |
liste	l i s t e |
lisumu	l i s u m u |
lisusu	l i s u s u |
litama	l i t a m a |
litanga	l i t a n g a |
litomba	l i t o m b a |
litoyi	l i t o y i |
litshombe	l i t s h o m b e |
liwa	l i w a |
liyeli	l i y e l i |
liziba	l i z i b a |
loba	l o b a |
lobela	l o b e l a |
lobeto	l o b e t o |
lobi	l o b i |
loboko	l o b o k o |
lofundu	l o f u n d u |
logique	l o g i q u e |
lokasa	l o k a s a |
loketo	l o k e t o |
lokola	l o k o l a |
lokolo	l o k o l o |
lokumu	l o k u m u |
lokuta	l o k u t a |
lola	l o l a |
lolemo	l o l e m o |
lolendo	l o l e n d o |
lolenge	l o l e n g e |
lombango	l o m b a n g o |
lombangu	l o m b a n g u |
lommbangu	l o m m b a n g u |
londres	l o n d r e s |
longola	l o n g o l a |
longwa	l o n g w a |
loom	l o o m |
lopango	l o p a n g o |
lopitalo	l o p i t a l o |
loposo	l o p o s o |
losambo	l o s a m b o |
loso	l o s o |
lotomo	l o t o m o |
love	l o v e |
loyembo	l o y e m b o |
loyenge	l o y e n g e |
luanda	l u a n d a |
lubumbashi	l u b u m b a s h i |
luka	l u k a |
lukutu	l u k u t u |
lumiere	l u m i e r e |
lumumba	l u m u m b a |
lunda	l u n d a |
luozi	l u o z i |
lupemba	l u p e m b a |
luvunu	l u v u n u |
luzitu	l u z i t u |
lɛlɔ	l ɛ l ɔ |
lɛlɔkaka	l ɛ l ɔ k a k a |
m	m |
ma	m a |
maba	m a b a |
mabaluka	m a b a l u k a |
mabandi	m a b a n d i |
mabanga	m a b a n g a |
mabanki	m a b a n k i |
mabanzo	m a b a n z o |
mabaya	m a b a y a |
mabe	m a b e |
mabele	m a b e l e |
mabende	m a b e n d e |
mabiki	m a b i k i |
mabina	m a b i n a |
maboma	m a b o m a |
mabonza	m a b o n z a |
mabota	m a b o t a |
mabuluki	m a b u l u k i |
mabɔkɔ	m a b ɔ k ɔ |
machine	m a c h i n e |
madesu	m a d e s u |
mafu	m a f u |
mafuta	m a f u t a |
magasin	m a g a s i n |
magie	m a g i e |
mahele	m a h e l e |
mais	m a i s |
maitrizaka	m a i t r i z a k a |
makala	m a k a l a |
makalekale	m a k a l e k a l e |
makambo	m a k a m b o |
makambu	m a k a m b u |
makambuango	m a k a m b u a n g o |
makanisi	m a k a n i s i |
makaramba	m a k a r a m b a |
makasa	m a k a s a |
makasi	m a k a s i |
makelele	m a k e l e l e |
maki	m a k i |
makila	m a k i l a |
makoki	m a k o k i |
makolo	m a k o l o |
makomaki	m a k o m a k i |
makomi	m a k o m i |
makɔfi	m a k ɔ f i |
maladi	m a l a d i |
malamu	m a l a m u |
malamumalamu	m a l a m u m a l a m u |
malaria	m a l a r i a |
malasi	m a l a s i |
malekaki	m a l e k a k i |
malewa	m a l e w a |
malili	m a l i l i |
maloba	m a l o b a |
malonga	m a l o n g a |
malɛmbɛ	m a l ɛ m b ɛ |
malɛmbɛmalɛmbɛ	m a l ɛ m b ɛ m a l ɛ m b ɛ |
mama	m a m a |
mamaleki	m a m a l e k i |
mamona	m a m o n a |
mana	m a n a |
manga	m a n g a |
mangaselo	m a n g a s e l o |
mangbongi	m a n g b o n g i |
mango	m a n g o |
mangomba	m a n g o m b a |
mangondo	m a n g o n d o |
mangungu	m a n g u n g u |
manso	m a n s o |
manteka	m a n t e k a |
mapamboli	m a p a m b o l i |
mapango	m a p a n g o |
mapapu	m a p a p u |
mapata	m a p a t a |
maponomi	m a p o n o m i |
maputa	m a p u t a |
marc	m a r c |
marchandise	m a r c h a n d i s e |
marche	m a r c h e |
marches	m a r c h e s |
mardi	m a r d i |
marechal	m a r e c h a l |
marielouise	m a r i e l o u i s e |
mariya	m a r i y a |
marque	m a r q u e |
martyr	m a r t y r |
masanga	m a s a n g a |
masango	m a s a n g o |
masasi	m a s a s i |
masasu	m a s a s u |
masina	m a s i n a |
masolango	m a s o l a n g o |
masolo	m a s o l o |
masta	m a s t a |
masumu	m a s u m u |
masuwa	m a s u w a |
mataba	m a t a b a |
matakanelo	m a t a k a n e l o |
matama	m a t a m a |
matanga	m a t a n g a |
match	m a t c h |
matela	m a t e l a |
matembɛlɛ	m a t e m b ɛ l ɛ |
maternelle	m a t e r n e l l e |
mateya	m a t e y a |
mathematique	m a t h e m a t i q u e |
matiti	m a t i t i |
matolo	m a t o l o |
matonge	m a t o n g e |
matoyi	m a t o y i |
matrice	m a t r i c e |
matshombe	m a t s h o m b e |
mawa	m a w a |
mayanga	m a y a n g a |
mayi	m a y i |
mayuya	m a y u y a |
mayɔnnaise	m a y ɔ n n a i s e |
mayɛlɛ	m a y ɛ l ɛ |
mazalaki	m a z a l a k i |
mazali	m a z a l i |
mbala	m b a l a |
mbalakaka	m b a l a k a k a |
mbamba	m b a m b a |
mbanda	m b a n d a |
mbandaka	m b a n d a k a |
mbanga	m b a n g a |
mbango	m b a n g o |
mbangu	m b a n g u |
mbata	m b a t a |
mbati	m b a t i |
mbeka	m b e k a |
mbentenge	m b e n t e n g e |
mbetenge	m b e t e n g e |
mbila	m b i l a |
mbindo	m b i n d o |
mbinga	m b i n g a |
mbisi	m b i s i |
mbogo	m b o g o |
mboka	m b o k a |
mbondo	m b o n d o |
mbote	m b o t e |
mbu	m b u |
mbuji	m b u j i |
mbula	m b u l a |
mbunzu	m b u n z u |
mbɔngɔ	m b ɔ n g ɔ |
mbɛli	m b ɛ l i |
mbɛlɛ	m b ɛ l ɛ |
mbɛto	m b ɛ t o |
meka	m e k a |
meke	m e k e |
memela	m e m e l a |
memoire	m e m o i r e |
menace	m e n a c e |
menkao	m e n k a o |
mercedes	m e r c e d e s |
mere	m e r e |
mesa	m e s a |
mfumu	m f u m u |
miami	m i a m i |
mibale	m i b a l e |
mibali	m i b a l i |
mibimba	m i b i m b a |
mibwa	m i b w a |
micro	m i c r o |
midi	m i d i |
miguel	m i g u e l |
mikanda	m i k a n d a |
mike	m i k e |
mikemike	m i k e m i k e |
mikieee	m i k i e e e |
mikili	m i k i l i |
mikiliste	m i k i l i s t e |
mikokaki	m i k o k a k i |
mikolo	m i k o l o |
mikondo	m i k o n d o |
mikuwa	m i k u w a |
milangi	m i l a n g i |
milayi	m i l a y i |
miliki	m i l i k i |
milimo	m i l i m o |
milio	m i l i o |
militaire	m i l i t a i r e |
mille	m i l l e |
million	m i l l i o n |
millionnaires	m i l l i o n n a i r e s |
milolo	m i l o l o |
milɛlɔ	m i l ɛ l ɔ |
mimekano	m i m e k a n o |
mindoki	m i n d o k i |
minduki	m i n d u k i |
mindɔndɔ	m i n d ɔ n d ɔ |
mindɛlɛ	m i n d ɛ l ɛ |
minei	m i n e i |
minene	m i n e n e |
mingamba	m i n g a m b a |
minganga	m i n g a n g a |
mingi	m i n g i |
mingimingi	m i n g i m i n g i |
ministre	m i n i s t r e |
miniti	m i n i t i |
mino	m i n o |
minoko	m i n o k o |
minuit	m i n u i t |
minute	m i n u t e |
minutes	m i n u t e s |
minyɔkɔ	m i n y ɔ k ɔ |
mipanzi	m i p a n z i |
mipende	m i p e n d e |
mipepe	m i p e p e |
miraesa	m i r a e s a |
misala	m i s a l a |
misato	m i s a t o |
misere	m i s e r e |
misi	m i s i |
miso	m i s o |
misolo	m i s o l o |
mission	m i s s i o n |
misuni	m i s u n i |
misusu	m i s u s u |
misusubisika	m i s u s u b i s i k a |
mitano	m i t a n o |
mitelengano	m i t e l e n g a n o |
mitema	m i t e m a |
mitindo	m i t i n d o |
mitu	m i t u |
mituka	m i t u k a |
mituna	m i t u n a |
mituya	m i t u y a |
miye	m i y e |
miyibi	m i y i b i |
miyɔyɔ	m i y ɔ y ɔ |
mizalaki	m i z a l a k i |
miziki	m i z i k i |
mmbangu	m m b a n g u |
mmbangummbangu	m m b a n g u m m b a n g u |
mobali	m o b a l i |
mobatelinzoto	m o b a t e l i n z o t o |
mobebisa	m o b e b i s a |
mobebisasi	m o b e b i s a s i |
mobembo	m o b e m b o |
mobeti	m o b e t i |
mobimba	m o b i m b a |
mobokoli	m o b o k o l i |
mobola	m o b o l a |
mobu	m o b u |
mobukanaki	m o b u k a n a k i |
mobulu	m o b u l u |
mobutu	m o b u t u |
mode	m o d e |
modele	m o d e l e |
mohamed	m o h a m e d |
moindo	m o i n d o |
moins	m o i n s |
mois	m o i s |
moise	m o i s e |
mokali	m o k a l i |
mokanda	m o k a n d a |
mokano	m o k a n o |
mokatana	m o k a t a n a |
mokebato	m o k e b a t o |
mokili	m o k i l i |
moko	m o k o |
mokolo	m o k o l o |
mokoloto	m o k o l o t o |
mokomi	m o k o m i |
mokongo	m o k o n g o |
mokonzi	m o k o n z i |
mokosuka	m o k o s u k a |
mokumba	m o k u m b a |
mokumbi	m o k u m b i |
mokumbɛli	m o k u m b ɛ l i |
mokuse	m o k u s e |
mokuwa	m o k u w a |
mokuya	m o k u y a |
mokɛ	m o k ɛ |
mokɛngeli	m o k ɛ n g e l i |
molakisi	m o l a k i s i |
molangi	m o l a n g i |
molayi	m o l a y i |
molende	m o l e n d e |
molili	m o l i l i |
molimo	m o l i m o |
molingi	m o l i n g i |
moluba	m o l u b a |
moluka	m o l u k a |
moluki	m o l u k i |
molunge	m o l u n g e |
mombɔngɔ	m o m b ɔ n g ɔ |
momeseno	m o m e s e n o |
momie	m o m i e |
mon	m o n |
mona	m o n a |
monano	m o n a n o |
monde	m o n d e |
mondoki	m o n d o k i |
mondokinawa	m o n d o k i n a w a |
mondoyɔ	m o n d o y ɔ |
mondɛlɛ	m o n d ɛ l ɛ |
monene	m o n e n e |
mongaba	m o n g a b a |
mongali	m o n g a l i |
monganga	m o n g a n g a |
mongo	m o n g o |
mongongo	m o n g o n g o |
moninga	m o n i n g a |
mono	m o n o |
monoko	m o n o k o |
montre	m o n t r e |
monyato	m o n y a t o |
monzemba	m o n z e m b a |
monzoto	m o n z o t o |
mopanzi	m o p a n z i |
mopao	m o p a o |
mopaya	m o p a y a |
mopepe	m o p e p e |
moperso	m o p e r s o |
mopesi	m o p e s i |
mopiko	m o p i k o |
moprezo	m o p r e z o |
moro	m o r o |
mosaka	m o s a k a |
mosala	m o s a l a |
mosali	m o s a l i |
mosantu	m o s a n t u |
mosapi	m o s a p i |
mosengi	m o s e n g i |
mosenzi	m o s e n z i |
moshe	m o s h e |
mosika	m o s i k a |
mosilaki	m o s i l a k i |
mosili	m o s i l i |
mosisa	m o s i s a |
mosolo	m o s o l o |
mosuni	m o s u n i |
mosusu	m o s u s u |
motane	m o t a n e |
motema	m o t e m a |
motindo	m o t i n d o |
moto	m o t o |
motoba	m o t o b a |
motuka	m o t u k a |
motuna	m o t u n a |
motuya	m o t u y a |
move	m o v e |
mowei	m o w e i |
moyeke	m o y e k e |
moyekoli	m o y e k o l i |
moyen	m o y e n |
moyi	m o y i |
moyiangola	m o y i a n g o l a |
moyibi	m o y i b i |
moyike	m o y i k e |
moyimoyi	m o y i m o y i |
moziki	m o z i k i |
mozindo	m o z i n d o |
mozipami	m o z i p a m i |
mpamba	m p a m b a |
mpasi	m p a s i |
mpate	m p a t e |
mpe	m p e |
mpema	m p e m a |
mpenza	m p e n z a |
mpiaka	m p i a k a |
mpinzoli	m p i n z o l i |
mpio	m p i o |
mpion	m p i o n |
mpo	m p o |
mpokwa	m p o k w a |
mpomba	m p o m b a |
mposa	m p o s a |
mposo	m p o s o |
mpu	m p u |
mpunda	m p u n d a |
mputu	m p u t u |
mpwasa	m p w a s a |
mpɔna	m p ɔ n a |
mpɔngi	m p ɔ n g i |
mpɔta	m p ɔ t a |
mpɛmbɛ	m p ɛ m b ɛ |
mpɛmbɛni	m p ɛ m b ɛ n i |
muconfia	m u c o n f i a |
mufa	m u f a |
muji	m u j i |
mukanda	m u k a n d a |
muke	m u k e |
mukolo	m u k o l o |
mulayi	m u l a y i |
mulongo	m u l o n g o |
mumbafu	m u m b a f u |
mundanda	m u n d a n d a |
mundɛlɛ	m u n d ɛ l ɛ |
munkamba	m u n k a m b a |
muntu	m u n t u |
mupela	m u p e l a |
mur	m u r |
mura	m u r a |
mususu	m u s u s u |
mutu	m u t u |
mutuangani	m u t u a n g a n i |
mutuango	m u t u a n g o |
mutuka	m u t u k a |
mvula	m v u l a |
mwa	m w a |
mwambe	m w a m b e |
mwana	m w a n a |
mwananyoka	m w a n a n y o k a |
mwasi	m w a s i |
mwenedintu	m w e n e d i n t u |
mwindu	m w i n d u |
mystique	m y s t i q u e |
mɔlɔngɔ	m ɔ l ɔ n g ɔ |
mɔtɔ	m ɔ t ɔ |
mɔtɔki	m ɔ t ɔ k i |
mɔtɔmboki	m ɔ t ɔ m b o k i |
mɔtɔrisee	m ɔ t ɔ r i s e e |
mɔtɔrs	m ɔ t ɔ r s |
na	n a |
nabala	n a b a l a |
nabanga	n a b a n g a |
nabengaki	n a b e n g a k i |
nabeta	n a b e t a |
nabetelaki	n a b e t e l a k i |
nabokola	n a b o k o l a |
nabomaboma	n a b o m a b o m a |
nabomaki	n a b o m a k i |
nabomi	n a b o m i |
nabomisi	n a b o m i s i |
nabongoli	n a b o n g o l i |
nabosana	n a b o s a n a |
nabosanaki	n a b o s a n a k i |
nabota	n a b o t a |
nabotama	n a b o t a m a |
naboti	n a b o t i |
naboulonaka	n a b o u l o n a k a |
naboyaki	n a b o y a k i |
naboyi	n a b o y i |
nabukanaki	n a b u k a n a k i |
nabuki	n a b u k i |
nafanda	n a f a n d a |
nafandaka	n a f a n d a k a |
nafutela	n a f u t e l a |
nafutelaka	n a f u t e l a k a |
naino	n a i n o |
nakangaki	n a k a n g a k i |
nakangi	n a k a n g i |
nakanisa	n a k a n i s a |
nakanisaki	n a k a n i s a k i |
nakanisi	n a k a n i s i |
nakata	n a k a t a |
nakengelaka	n a k e n g e l a k a |
nakeyi	n a k e y i |
nakima	n a k i m a |
nakipaka	n a k i p a k a |
nakobanda	n a k o b a n d a |
nakobengisa	n a k o b e n g i s a |
nakobeta	n a k o b e t a |
nakobima	n a k o b i m a |
nakobimisa	n a k o b i m i s a |
nakobokola	n a k o b o k o l a |
nakoboma	n a k o b o m a |
nakofazer	n a k o f a z e r |
nakofuta	n a k o f u t a |
nakoki	n a k o k i |
nakokisa	n a k o k i s a |
nakokitisa	n a k o k i t i s a |
nakokoka	n a k o k o k a |
nakokufa	n a k o k u f a |
nakokɛndɛ	n a k o k ɛ n d ɛ |
nakolakisa	n a k o l a k i s a |
nakoleka	n a k o l e k a |
nakoloba	n a k o l o b a |
nakolobela	n a k o l o b e l a |
nakoluka	n a k o l u k a |
nakoma	n a k o m a |
nakomaki	n a k o m a k i |
nakomanquer	n a k o m a n q u e r |
nakomeli	n a k o m e l i |
nakomema	n a k o m e m a |
nakomi	n a k o m i |
nakomiboma	n a k o m i b o m a |
nakopanza	n a k o p a n z a |
nakopesa	n a k o p e s a |
nakopesela	n a k o p e s e l a |
nakoprouver	n a k o p r o u v e r |
nakosala	n a k o s a l a |
nakosangisa	n a k o s a n g i s a |
nakoseka	n a k o s e k a |
nakosoli	n a k o s o l i |
nakosomba	n a k o s o m b a |
nakosuka	n a k o s u k a |
nakotaki	n a k o t a k i |
nakotikela	n a k o t i k e l a |
nakotindela	n a k o t i n d e l a |
nakotumba	n a k o t u m b a |
nakoya	n a k o y a |
nakoyebisa	n a k o y e b i s a |
nakoyiba	n a k o y i b a |
nakozala	n a k o z a l a |
nakozela	n a k o z e l a |
nakozonga	n a k o z o n g a |
nakozwa	n a k o z w a |
nakufa	n a k u f a |
nakufi	n a k u f i |
nakumbɛli	n a k u m b ɛ l i |
nakutana	n a k u t a n a |
nakutanaki	n a k u t a n a k i |
nakutani	n a k u t a n i |
nakɛndaki	n a k ɛ n d a k i |
nakɛndɛ	n a k ɛ n d ɛ |
nalambaka	n a l a m b a k a |
nalamuka	n a l a m u k a |
nalamukaki	n a l a m u k a k i |
nalapaka	n a l a p a k a |
naleka	n a l e k a |
nalingaka	n a l i n g a k a |
nalingaki	n a l i n g a k i |
nalingi	n a l i n g i |
naloba	n a l o b a |
nalobaki	n a l o b a k i |
nalobela	n a l o b e l a |
nalobi	n a l o b i |
nalonaki	n a l o n a k i |
nalongwa	n a l o n g w a |
nalongwaka	n a l o n g w a k a |
nalova	n a l o v a |
nalukaka	n a l u k a k a |
naluki	n a l u k i |
nalulaki	n a l u l a k i |
nalɛmbaki	n a l ɛ m b a k i |
nalɛmbi	n a l ɛ m b i |
namemaki	n a m e m a k i |
namilobelaki	n a m i l o b e l a k i |
namilukelaka	n a m i l u k e l a k a |
namituna	n a m i t u n a |
namona	n a m o n a |
namonaki	n a m o n a k i |
namoni	n a m o n i |
nandimbolela	n a n d i m b o l e l a |
nani	n a n i |
nanu	n a n u |
nanyata	n a n y a t a |
napanzela	n a p a n z e l a |
napekisaki	n a p e k i s a k i |
napesa	n a p e s a |
napesaka	n a p e s a k a |
napesaki	n a p e s a k i |
nasala	n a s a l a |
nasalaka	n a s a l a k a |
nasalaki	n a s a l a k i |
nasali	n a s a l i |
nasalisa	n a s a l i s a |
nasamba	n a s a m b a |
nasangisa	n a s a n g i s a |
nasanzele	n a s a n z e l e |
nasengi	n a s e n g i |
nasepelaki	n a s e p e l a k i |
nasi	n a s i |
nasilisa	n a s i l i s a |
nasimbaki	n a s i m b a k i |
nasimbi	n a s i m b i |
nasoldela	n a s o l d e l a |
nasombi	n a s o m b i |
nasuki	n a s u k i |
nasunga	n a s u n g a |
nasuta	n a s u t a |
natali	n a t a l i |
nateka	n a t e k a |
natekaka	n a t e k a k a |
natekelaki	n a t e k e l a k i |
natelema	n a t e l e m a |
natelemaki	n a t e l e m a k i |
natia	n a t i a |
natie	n a t i e |
natielaki	n a t i e l a k i |
natika	n a t i k a |
natikela	n a t i k e l a |
natimbela	n a t i m b e l a |
natosaka	n a t o s a k a |
natunaki	n a t u n a k i |
natuni	n a t u n i |
nawangana	n a w a n g a n a |
nawelaki	n a w e l a k i |
naweli	n a w e l i |
nawuta	n a w u t a |
nawutaka	n a w u t a k a |
nawuti	n a w u t i |
naya	n a y a |
nayaka	n a y a k a |
nayaki	n a y a k i |
nayamba	n a y a m b a |
nayambaki	n a y a m b a k i |
naye	n a y e |
nayeba	n a y e b a |
nayebaka	n a y e b a k a |
nayebaki	n a y e b a k i |
nayebi	n a y e b i |
nayebisa	n a y e b i s a |
nayebisaki	n a y e b i s a k i |
nayebisi	n a y e b i s i |
nayibaka	n a y i b a k a |
nayoka	n a y o k a |
nayokaka	n a y o k a k a |
nayokaki	n a y o k a k i |
nayokisa	n a y o k i s a |
nazala	n a z a l a |
nazalaka	n a z a l a k a |
nazalaki	n a z a l a k i |
nazali	n a z a l i |
nazangi	n a z a n g i |
nazobenga	n a z o b e n g a |
nazodondwa	n a z o d o n d w a |
nazoka	n a z o k a |
nazolambela	n a z o l a m b e l a |
nazolekisa	n a z o l e k i s a |
nazomona	n a z o m o n a |
nazonga	n a z o n g a |
nazongaka	n a z o n g a k a |
nazongaki	n a z o n g a k i |
nazongi	n a z o n g i |
nazotala	n a z o t a l a |
nazozela	n a z o z e l a |
nazwa	n a z w a |
nazwaki	n a z w a k i |
nazwi	n a z w i |
ndai	n d a i |
ndakisa	n d a k i s a |
ndako	n d a k o |
ndaku	n d a k u |
ndakuango	n d a k u a n g o |
ndambo	n d a m b o |
ndambu	n d a m b u |
nde	n d e |
ndeko	n d e k o |
ndelo	n d e l o |
ndenge	n d e n g e |
ndikila	n d i k i l a |
ndinga	n d i n g a |
ndingisa	n d i n g i s a |
ndjili	n d j i l i |
ndoki	n d o k i |
ndonge	n d o n g e |
ndumba	n d u m b a |
ndɔtɔ	n d ɔ t ɔ |
ndɛkɛ	n d ɛ k ɛ |
ndɛlɛ	n d ɛ l ɛ |
ne	n e |
nesprit	n e s p r i t |
neti	n e t i |
nettoyage	n e t t o y a g e |
neuf	n e u f |
neuve	n e u v e |
newyɔrk	n e w y ɔ r k |
nga	n g a |
ngai	n g a i |
ngala	n g a l a |
ngambo	n g a m b o |
ngana	n g a n a |
nganda	n g a n d a |
ngangamayɛlɛ	n g a n g a m a y ɛ l ɛ |
ngaya	n g a y a |
ngayi	n g a y i |
ngbaka	n g b a k a |
ngbanda	n g b a n d a |
ngenge	n g e n g e |
ngolo	n g o l o |
ngolu	n g o l u |
ngonga	n g o n g a |
ngubu	n g u b u |
ngulu	n g u l u |
ngulupa	n g u l u p a |
nguma	n g u m a |
ngunda	n g u n d a |
ngungi	n g u n g i |
nguya	n g u y a |
ngwa	n g w a |
niarcos	n i a r c o s |
nido	n i d o |
nini	n i n i |
niveau	n i v e a u |
nka	n k a |
nkale	n k a l e |
nkama	n k a m a |
nkanda	n k a n d a |
nkasi	n k a s i |
nkema	n k e m a |
nkembo	n k e m b o |
nketo	n k e t o |
nkita	n k i t a |
nko	n k o |
nkombo	n k o m b o |
nkoto	n k o t o |
nkuku	n k u k u |
nkunda	n k u n d a |
nkɛlɛ	n k ɛ l ɛ |
nnsima	n n s i m a |
nntembe	n n t e m b e |
noir	n o i r |
noko	n o k o |
non	n o n |
nord	n o r d |
normal	n o r m a l |
nous	n o u s |
nouvelle	n o u v e l l e |
nsamba	n s a m b a |
nsambo	n s a m b o |
nsango	n s a n g o |
nsele	n s e l e |
nsima	n s i m a |
nsimanalobi	n s i m a n a l o b i |
nsinga	n s i n g a |
nsoso	n s o s o |
nsoul	n s o u l |
nsɔmɔ	n s ɔ m ɔ |
nsɔni	n s ɔ n i |
ntaka	n t a k a |
ntango	n t a n g o |
ntangu	n t a n g u |
nteba	n t e b a |
ntela	n t e l a |
ntembe	n t e m b e |
ntina	n t i n a |
ntuku	n t u k u |
ntɔngɔ	n t ɔ n g ɔ |
ntɔngɔntɔngɔ	n t ɔ n g ɔ n t ɔ n g ɔ |
nwa	n w a |
nyama	n y a m a |
nyangalakata	n y a n g a l a k a t a |
nye	n y e |
nyere	n y e r e |
nyoka	n y o k a |
nyɔngo	n y ɔ n g o |
nyɔnso	n y ɔ n s o |
nyɔsɔ	n y ɔ s ɔ |
nzakomba	n z a k o m b a |
nzala	n z a l a |
nzali	n z a l i |
nzambe	n z a m b e |
nzela	n z e l a |
nzelanzela	n z e l a n z e l a |
nzele	n z e l e |
nzete	n z e t e |
nzingakuvu	n z i n g a k u v u |
nzoka	n z o k a |
nzokande	n z o k a n d e |
nzoto	n z o t o |
nzoyi	n z o y i |
nzutu	n z u t u |
obaka	o b a k a |
obakisa	o b a k i s a |
obala	o b a l a |
obali	o b a l i |
obaloli	o b a l o l i |
obandaki	o b a n d a k i |
obandi	o b a n d i |
obaye	o b a y e |
obeba	o b e b a |
obendani	o b e n d a n i |
obengi	o b e n g i |
obeta	o b e t a |
obeti	o b e t i |
obiki	o b i k i |
obima	o b i m a |
obimi	o b i m i |
obimisaka	o b i m i s a k a |
obokola	o b o k o l a |
oboma	o b o m a |
obomaki	o b o m a k i |
obomba	o b o m b a |
obongisa	o b o n g i s a |
obosani	o b o s a n i |
obota	o b o t a |
oboter	o b o t e r |
oboyaka	o b o y a k a |
oboyi	o b o y i |
obundi	o b u n d i |
obɔtɔla	o b ɔ t ɔ l a |
ococher	o c o c h e r |
ocontinuer	o c o n t i n u e r |
ofanda	o f a n d a |
ofandi	o f a n d i |
ofazer	o f a z e r |
office	o f f i c e |
ofinga	o f i n g a |
ofutela	o f u t e l a |
okangi	o k a n g i |
okangisi	o k a n g i s i |
okanisaki	o k a n i s a k i |
okanisi	o k a n i s i |
okeyi	o k e y i |
okobanda	o k o b a n d a |
okobeba	o k o b e b a |
okobeta	o k o b e t a |
okoexpliquer	o k o e x p l i q u e r |
okofanda	o k o f a n d a |
okofuta	o k o f u t a |
okokaki	o k o k a k i |
okokanisa	o k o k a n i s a |
okoki	o k o k i |
okokoma	o k o k o m a |
okokufa	o k o k u f a |
okokuta	o k o k u t a |
okokutana	o k o k u t a n a |
okokɛndɛ	o k o k ɛ n d ɛ |
okolakisa	o k o l a k i s a |
okolata	o k o l a t a |
okoleka	o k o l e k a |
okolia	o k o l i a |
okolonga	o k o l o n g a |
okoma	o k o m a |
okomata	o k o m a t a |
okomi	o k o m i |
okomikoka	o k o m i k o k a |
okomona	o k o m o n a |
okondima	o k o n d i m a |
okopema	o k o p e m a |
okopesa	o k o p e s a |
okorever	o k o r e v e r |
okosala	o k o s a l a |
okosepela	o k o s e p e l a |
okosuka	o k o s u k a |
okosutuka	o k o s u t u k a |
okota	o k o t a |
okotangisa	o k o t a n g i s a |
okoti	o k o t i |
okotikala	o k o t i k a l a |
okotimbela	o k o t i m b e l a |
okotindela	o k o t i n d e l a |
okoya	o k o y a |
okoyoka	o k o y o k a |
okozala	o k o z a l a |
okozela	o k o z e l a |
okozwa	o k o z w a |
okufi	o k u f i |
okɛnda	o k ɛ n d a |
okɛndaki	o k ɛ n d a k i |
okɛndɛ	o k ɛ n d ɛ |
okɛndɛki	o k ɛ n d ɛ k i |
olalaki	o l a l a k i |
olataka	o l a t a k a |
olati	o l a t i |
oleki	o l e k i |
olela	o l e l a |
olesaka	o l e s a k a |
oliaka	o l i a k a |
olinga	o l i n g a |
olingaka	o l i n g a k a |
olingi	o l i n g i |
oliya	o l i y a |
oloba	o l o b a |
olobaki	o l o b a k i |
olobi	o l o b i |
olomide	o l o m i d e |
olonga	o l o n g a |
olongwa	o l o n g w a |
omeka	o m e k a |
omibomeli	o m i b o m e l i |
omitiki	o m i t i k i |
omona	o m o n a |
omonaki	o m o n a k i |
omoni	o m o n i |
omɛla	o m ɛ l a |
on	o n |
ong	o n g |
onu	o n u |
onyati	o n y a t i |
onyɔkɔlaki	o n y ɔ k ɔ l a k i |
oo	o o |
opepi	o p e p i |
operation	o p e r a t i o n |
opesa	o p e s a |
opesi	o p e s i |
ophoner	o p h o n e r |
opposition	o p p o s i t i o n |
opusani	o p u s a n i |
opɔni	o p ɔ n i |
ordonnance	o r d o n n a n c e |
orever	o r e v e r |
osala	o s a l a |
osalaka	o s a l a k a |
osali	o s a l i |
osi	o s i |
osila	o s i l a |
osilisa	o s i l i s a |
osilisi	o s i l i s i |
osolola	o s o l o l a |
osombela	o s o m b e l a |
osombi	o s o m b i |
otali	o t a l i |
otanga	o t a n g a |
otangama	o t a n g a m a |
otangi	o t a n g i |
oteki	o t e k i |
otekisi	o t e k i s i |
otia	o t i a |
otie	o t i e |
otiki	o t i k i |
otingama	o t i n g a m a |
otomboli	o t o m b o l i |
otongi	o t o n g i |
otuni	o t u n i |
otɔnga	o t ɔ n g a |
oui	o u i |
owuti	o w u t i |
oya	o y a |
oyaki	o y a k i |
oye	o y e |
oyeba	o y e b a |
oyebana	o y e b a n a |
oyebi	o y e b i |
oyebisaki	o y e b i s a k i |
oyebisi	o y e b i s i |
oyibaki	o y i b a k i |
oyibi	o y i b i |
oyoki	o y o k i |
oyɔ	o y ɔ |
oza	o z a |
ozalaka	o z a l a k a |
ozalaki	o z a l a k i |
ozali	o z a l i |
ozangi	o z a n g i |
ozo	o z o |
ozodondwela	o z o d o n d w e l a |
ozokufa	o z o k u f a |
ozoloba	o z o l o b a |
ozoluka	o z o l u k a |
ozomona	o z o m o n a |
ozongi	o z o n g i |
ozongisa	o z o n g i s a |
ozongisi	o z o n g i s i |
ozosolola	o z o s o l o l a |
ozoya	o z o y a |
ozozwela	o z o z w e l a |
ozwa	o z w a |
ozwaka	o z w a k a |
ozwi	o z w i |
palais	p a l a i s |
palata	p a l a t a |
panama	p a n a m a |
pantalon	p a n t a l o n |
papa	p a p a |
papafinance	p a p a f i n a n c e |
papier	p a p i e r |
par	p a r |
paradis	p a r a d i s |
pardon	p a r d o n |
parebrise	p a r e b r i s e |
paris	p a r i s |
parking	p a r k i n g |
parlerenlangue	p a r l e r e n l a n g u e |
parmi	p a r m i |
parti	p a r t i |
partie	p a r t i e |
pas	p a s |
pascal	p a s c a l |
pasi	p a s i |
passeport	p a s s e p o r t |
passer	p a s s e r |
pasta	p a s t a |
pastafinance	p a s t a f i n a n c e |
pastamapamboli	p a s t a m a p a m b o l i |
patron	p a t r o n |
pawu	p a w u |
pe	p e |
pema	p e m a |
pepe	p e p e |
pepo	p e p o |
pere	p e r e |
periode	p e r i o d e |
permission	p e r m i s s i o n |
pesa	p e s a |
petit	p e t i t |
physique	p h y s i q u e |
pickup	p i c k u p |
pierre	p i e r r e |
pilote	p i l o t e |
pine	p i n e |
plafond	p l a f o n d |
plateau	p l a t e a u |
plus	p l u s |
pmu	p m u |
po	p o |
poche	p o c h e |
pointenoire	p o i n t e n o i r e |
polele	p o l e l e |
police	p o l i c e |
policier	p o l i c i e r |
politiki	p o l i t i k i |
pompe	p o m p e |
pondu	p o n d u |
pongi	p o n g i |
pontgaby	p o n t g a b y |
pontkasavubu	p o n t k a s a v u b u |
ponton	p o n t o n |
populaire	p o p u l a i r e |
porowe	p o r o w e |
porte	p o r t e |
posa	p o s a |
position	p o s i t i o n |
poso	p o s o |
poste	p o s t e |
poto	p o t o |
pprd	p p r d |
preavis	p r e a v i s |
president	p r e s i d e n t |
preuve	p r e u v e |
primus	p r i m u s |
prix	p r i x |
probleme	p r o b l e m e |
prof	p r o f |
professeur	p r o f e s s e u r |
prophetie	p r o p h e t i e |
puis	p u i s |
pusu	p u s u |
pɛnɛ	p ɛ n ɛ |
pɛnɛpɛnɛ	p ɛ n ɛ p ɛ n ɛ |
quantite	q u a n t i t e |
quarante	q u a r a n t e |
quartier	q u a r t i e r |
quatre	q u a t r e |
quatrieme	q u a t r i e m e |
que	q u e |
quel	q u e l |
qui	q u i |
quinze	q u i n z e |
quoi	q u o i |
radio	r a d i o |
raison	r a i s o n |
rapport	r a p p o r t |
reagan	r e a g a n |
realite	r e a l i t e |
rebelion	r e b e l i o n |
recherche	r e c h e r c h e |
recours	r e c o u r s |
redo	r e d o |
refouler	r e f o u l e r |
reglementaire	r e g l e m e n t a i r e |
religion	r e l i g i o n |
rendezvous	r e n d e z v o u s |
reponse	r e p o n s e |
respect	r e s p e c t |
restaurant	r e s t a u r a n t |
retard	r e t a r d |
retroviseur	r e t r o v i s e u r |
ricelle	r i c e l l e |
rien	r i e n |
rigo	r i g o |
robert	r o b e r t |
robinet	r o b i n e t |
rouge	r o u g e |
rwanda	r w a n d a |
rythme	r y t h m e |
sac	s a c |
sacoche	s a c o c h e |
saddam	s a d d a m |
saint	s a i n t |
sainte	s a i n t e |
sainteanne	s a i n t e a n n e |
sainthilaire	s a i n t h i l a i r e |
saintrombeau	s a i n t r o m b e a u |
saisons	s a i s o n s |
saki	s a k i |
sala	s a l a |
salaire	s a l a i r e |
salle	s a l l e |
salon	s a l o n |
sambo	s a m b o |
sanduku	s a n d u k u |
sangana	s a n g a n a |
sango	s a n g o |
sans	s a n s |
sante	s a n t e |
santu	s a n t u |
sanza	s a n z a |
sapato	s a p a t o |
sarah	s a r a h |
satana	s a t a n a |
savant	s a v a n t |
savons	s a v o n s |
scibe	s c i b e |
se	s e |
secondaire	s e c o n d a i r e |
securite	s e c u r i t e |
seka	s e k a |
selina	s e l i n a |
sene	s e n e |
senegal	s e n e g a l |
sentinelle	s e n t i n e l l e |
sentinnelle	s e n t i n n e l l e |
sepi	s e p i |
serie	s e r i e |
serieux	s e r i e u x |
service	s e r v i c e |
sheki	s h e k i |
shimboki	s h i m b o k i |
si	s i |
siege	s i e g e |
signal	s i g n a l |
signe	s i g n e |
sika	s i k a |
sikoyɔ	s i k o y ɔ |
siloe	s i l o e |
sim	s i m |
simba	s i m b a |
simisi	s i m i s i |
sinon	s i n o n |
sinzili	s i n z i l i |
sisca	s i s c a |
siska	s i s k a |
situation	s i t u a t i o n |
six	s i x |
smartphone	s m a r t p h o n e |
societe	s o c i e t e |
soda	s o d a |
soixante	s o i x a n t e |
soki	s o k i |
soko	s o k o |
sokoro	s o k o r o |
sokoto	s o k o t o |
solde	s o l d e |
solo	s o l o |
solosolo	s o l o s o l o |
solution	s o l u t i o n |
son	s o n |
sonde	s o n d e |
songe	s o n g e |
soucis	s o u c i s |
soulboth	s o u l b o t h |
soulier	s o u l i e r |
souvenir	s o u v e n i r |
soyi	s o y i |
springcourt	s p r i n g c o u r t |
stade	s t a d e |
state	s t a t e |
stervos	s t e r v o s |
subsistance	s u b s i s t a n c e |
succes	s u c c e s |
suffit	s u f f i t |
sujet	s u j e t |
suka	s u k a |
sukali	s u k a l i |
sukasuka	s u k a s u k a |
suki	s u k i |
sukuma	s u k u m a |
super	s u p e r |
surtout	s u r t o u t |
susi	s u s i |
syndicats	s y n d i c a t s |
synkin	s y n k i n |
systematique	s y s t e m a t i q u e |
ta	t a |
tableau	t a b l e a u |
taksi	t a k s i |
tala	t a l a |
talo	t a l o |
talu	t a l u |
tanga	t a n g a |
tango	t a n g o |
tangu	t a n g u |
tata	t a t a |
tatakulutu	t a t a k u l u t u |
tatamwasi	t a t a m w a s i |
taverne	t a v e r n e |
taxi	t a x i |
taxibus	t a x i b u s |
tcc	t c c |
te	t e |
tebakangi	t e b a k a n g i |
tein	t e i n |
telecel	t e l e c e l |
telefone	t e l e f o n e |
telema	t e l e m a |
telephone	t e l e p h o n e |
temps	t e m p s |
thiongo	t h i o n g o |
ti	t i |
tibia	t i b i a |
ticket	t i c k e t |
tidie	t i d i e |
tii	t i i |
tiii	t i i i |
tika	t i k a |
tikala	t i k a l a |
tin	t i n |
tina	t i n a |
to	t o |
tobanda	t o b a n d a |
tobandaki	t o b a n d a k i |
tobebanaki	t o b e b a n a k i |
tobeta	t o b e t a |
tobikaka	t o b i k a k a |
tobongisa	t o b o n g i s a |
tobukaka	t o b u k a k a |
tokata	t o k a t a |
tokeitofanda	t o k e i t o f a n d a |
tokobalana	t o k o b a l a n a |
tokobanga	t o k o b a n g a |
tokobokola	t o k o b o k o l a |
tokoki	t o k o k i |
tokokoma	t o k o k o m a |
tokolangwa	t o k o l a n g w a |
tokolia	t o k o l i a |
tokoloba	t o k o l o b a |
tokoma	t o k o m a |
tokomi	t o k o m i |
tokomona	t o k o m o n a |
tokosala	t o k o s a l a |
tokoseka	t o k o s e k a |
tokosilisa	t o k o s i l i s a |
tokosolola	t o k o s o l o l a |
tokosomba	t o k o s o m b a |
tokotala	t o k o t a l a |
tokotiya	t o k o t i y a |
tokutana	t o k u t a n a |
tokutanaka	t o k u t a n a k a |
tokutanaki	t o k u t a n a k i |
tokutani	t o k u t a n i |
tokɛnda	t o k ɛ n d a |
tokɛndɛ	t o k ɛ n d ɛ |
tolandaka	t o l a n d a k a |
toli	t o l i |
tolia	t o l i a |
tolingi	t o l i n g i |
tolo	t o l o |
toloba	t o l o b a |
tolobela	t o l o b e l a |
tolongolaka	t o l o n g o l a k a |
tolongwaki	t o l o n g w a k i |
toluka	t o l u k a |
tolɛmbi	t o l ɛ m b i |
tomanyɔmala	t o m a n y ɔ m a l a |
tombola	t o m b o l a |
tombolabwaka	t o m b o l a b w a k a |
tomesana	t o m e s a n a |
tomilukelaka	t o m i l u k e l a k a |
tomona	t o m o n a |
tomonaka	t o m o n a k a |
tompɔna	t o m p ɔ n a |
tondima	t o n d i m a |
topekisaka	t o p e k i s a k a |
tosala	t o s a l a |
tosalaka	t o s a l a k a |
tosi	t o s i |
tosilana	t o s i l a n a |
tosili	t o s i l i |
tosololaki	t o s o l o l a k i |
tosuki	t o s u k i |
totala	t o t a l a |
totalaka	t o t a l a k a |
toteka	t o t e k a |
totekaka	t o t e k a k a |
totika	t o t i k a |
tour	t o u r |
touristes	t o u r i s t e s |
tout	t o u t |
towutaka	t o w u t a k a |
toya	t o y a |
toyaka	t o y a k a |
toyeba	t o y e b a |
toyebaki	t o y e b a k i |
toyebi	t o y e b i |
toyoka	t o y o k a |
toyokaka	t o y o k a k a |
tozalaki	t o z a l a k i |
tozali	t o z a l i |
tozela	t o z e l a |
tozobeta	t o z o b e t a |
tozokoma	t o z o k o m a |
tozonga	t o z o n g a |
tozongela	t o z o n g e l a |
tozosolola	t o z o s o l o l a |
train	t r a i n |
tram	t r a m |
transco	t r a n s c o |
trente	t r e n t e |
tribune	t r i b u n e |
triomphal	t r i o m p h a l |
trois	t r o i s |
trop	t r o p |
tshanga	t s h a n g a |
tshangamuka	t s h a n g a m u k a |
tshiluba	t s h i l u b a |
tshindongo	t s h i n d o n g o |
tshotsho	t s h o t s h o |
tuku	t u k u |
tumba	t u m b a |
tuna	t u n a |
tv	t v |
type	t y p e |
tɔnga	t ɔ n g a |
un	u n |
unikin	u n i k i n |
universite	u n i v e r s i t e |
upc	u p c |
urgence	u r g e n c e |
usine	u s i n e |
uta	u t a |
utexco	u t e x c o |
uvira	u v i r a |
valeur	v a l e u r |
vegetale	v e g e t a l e |
velo	v e l o |
verite	v e r i t e |
vers	v e r s |
vert	v e r t |
veste	v e s t e |
victoire	v i c t o i r e |
vide	v i d e |
vie	v i e |
vieux	v i e u x |
villa	v i l l a |
ville	v i l l e |
vingt	v i n g t |
vingttrois	v i n g t t r o i s |
visa	v i s a |
visite	v i s i t e |
vita	v i t a |
voiture	v o i t u r e |
vol	v o l |
vote	v o t e |
vre	v r e |
vrema	v r e m a |
wa	w a |
wabu	w a b u |
wana	w a n a |
wapi	w a p i |
wemba	w e m b a |
westone	w e s t o n e |
wɛnzɛ	w ɛ n z ɛ |
y	y |
ya	y a |
yaka	y a k a |
yambo	y a m b o |
yango	y a n g o |
yaounde	y a o u n d e |
yaya	y a y a |
ye	y e |
yebi	y e b i |
yebika	y e b i k a |
yebisa	y e b i s a |
yuma	y u m a |
yɔ	y ɔ |
yɔka	y ɔ k a |
yɔko	y ɔ k o |
yɔmbɔngɔ	y ɔ m b ɔ n g ɔ |
zabolo	z a b o l o |
zadio	z a d i o |
zaire	z a i r e |
zaireango	z a i r e a n g o |
zaires	z a i r e s |
zairois	z a i r o i s |
zala	z a l a |
zamba	z a m b a |
zambazamba	z a m b a z a m b a |
zando	z a n d o |
zapo	z a p o |
zaventem	z a v e n t e m |
zela	z e l a |
zelo	z e l o |
zemi	z e m i |
zoba	z o b a |
zododo	z o d o d o |
zolo	z o l o |
zomi	z o m i |
zone	z o n e |
zonga	z o n g a |
zuwa	z u w a |
zwa	z w a |
